发送电子邮件	【發】送電子郵件
技术有限公司	技【術】有限公司
发展有限公司	【發】展有限公司
开发有限公司	開【發】有限公司
集团有限公司	集【團】有限公司
发布供求信息	【發】【佈】供求信息
北京市海淀区	北京市海【澱】區
提供技术支持	提供技【術】支持
制造有限公司	【制】造有限公司
职业技术学院	職業技【術】學院
经济社会发展	經濟社會【發】展
制品有限公司	【制】品有限公司
内蒙古自治区	內【蒙】古自治區
代表大会常务	代【表】大會常務
信息查询系统	信息查詢【係】統
接受记者采访	接受記者【採】訪
共产党员先进	共產【黨】員先進
专业技术人员	專業技【術】人員
北京师范大学	北京師【範】大學
全面建设小康	全【面】建設小康
保持共产党员	保持共產【黨】員
发布求购信息	【發】【佈】求購信息
人民代表大会	人民代【表】大會
值得注意的是	值得【注】意的是
药品监督管理	【藥】品監督管理
在全球范围内	在全球【範】圍內
摩托罗拉手机	摩【托】羅拉手機
免费发布信息	免費【發】【佈】信息
是怎样炼成的	是怎樣【煉】成的
人民广播电台	人民廣播電【臺】
这方面的经验	這方【面】的經驗
生产力的发展	生產力的【發】展
免费注册会员	免費【注】冊會員
质量管理体系	質量管理體【係】
质量体系认证	質量體【係】認證
质量技术监督	質量技【術】監督
中央控制系统	中央控【制】【係】統
连续供墨系统	連續供墨【係】統
有关部门批准	有關部門批【準】
大专以上学历	大專以上學【歷】
全面落实科学	全【面】落實科學
这是怎么回事	這是怎麼【回】事
因为我明白了	因爲我明白【了】
管理信息系统	管理信息【係】統
自己并不知道	自己【並】不知道
随着经济发展	隨著經濟【發】展
别人对自己的	【別】人對自己的
发展研究中心	【發】展研究中心
发展的新局面	【發】展的新局【面】
在适当的时候	在適【當】的時候
注意语言文明	【注】意語言文明
系统有限公司	【係】統有限公司
你怎么知道了	你怎麼知道【了】
对房地产开发	對房地產開【發】
相当长的时间	相【當】長的時間
市场经济体制	市場經濟體【制】
会同有关部门	會【同】有關部門
现在我明白了	現在我明白【了】
客户关系管理	客戶關【係】管理
最具代表性的	最具代【表】性的
管理体系认证	管理體【係】認證
有什么了不起	有什麼【了】不起
我死了我死了	我死【了】我死【了】
工程技术人员	工程技【術】人員
喂喂喂喂喂喂	【餵】【餵】【餵】【餵】【餵】【餵】
发布招聘信息	【發】【佈】招聘信息
志同道合的人	【志】【同】道合的人
在一定范围内	在一定【範】圍內
科学技术大学	科學技【術】大學
出人意料的是	【出】人意料的是
药业有限公司	【藥】業有限公司
生产力发展的	生產力【發】展的
中国经济发展	中國經濟【發】展
生产建设兵团	生產建設兵【團】
中国共产党人	中國共產【黨】人
战略合作伙伴	戰略合作【夥】伴
社会主义制度	社會主義【制】度
党风廉政建设	【黨】風廉政建設
电子商务平台	電子商務平【臺】
从某种意义上	從某【種】意義上
广西师范大学	廣西師【範】大學
万万没有想到	【萬】【萬】沒有想到
浦东发展银行	浦東【發】展銀行
采取有效措施	【採】取有效措施
信息管理系统	信息管理【係】統
学习天天向上	學習天天【向】上
美国总统布什	美國總統【佈】什
有什么关系呢	有什麼關【係】呢
已经准备好了	已經【準】備好【了】
人力资源开发	人力資源開【發】
现代企业制度	現代企業【制】度
什么时候回来	什麼時候【回】來
的时候并没有	的時候【並】沒有
国家食品药品	國家食品【藥】品
社会经济发展	社會經濟【發】展
只不过是一种	【只】不過是一【種】
据不完全统计	【據】不完全統計
深圳发展银行	深圳【發】展銀行
基础上增加了	基礎上增加【了】
人民政府应当	人民政府應【當】
忽然发现自己	忽然【發】現自己
持续快速发展	持續快速【發】展
注意力集中在	【注】意力集中在
广东发展银行	廣東【發】展銀行
的第一次见面	的第一次見【面】
管理干部学院	管理【幹】部學院
得到了进一步	得到【了】進一步
这是理所当然	這是理所【當】然
得到了充分的	得到【了】充分的
是怎么一回事	是怎麼一【回】事
有什么大不了	有什麼大不【了】
没有别的选择	沒有【別】的選擇
公开发行股票	公開【發】行股票
有意者请联系	有意者請聯【係】
疾病预防控制	疾病預防控【制】
那么多的回忆	那麼多的【回】憶
经济体制改革	經濟體【制】改革
新闻出版总署	新聞【出】版總署
华中师范大学	華中師【範】大學
提供了强大的	提供【了】強大的
全球中文论坛	全球中文論【壇】
应注意的问题	應【注】意的問題
华东师范大学	華東師【範】大學
现在我才发现	現在我【才】【發】現
另一方面也是	另一方【面】也是
制药有限公司	【制】【藥】有限公司
自己的世界里	自己的世界【里】
规范市场经济	規【範】市場經濟
提出宝贵意见	提【出】寶貴意見
合作伙伴关系	合作【夥】伴關【係】
什么才是真正	什麼【才】是真正
中国科学技术	中國科學技【術】
市场经济发展	市場經濟【發】展
这样才能保证	這樣【才】能保證
共产党领导的	共產【黨】領導的
这样的事发生	這樣的事【發】生
社会的发展和	社會的【發】展和
只有一个念头	【只】有一個念頭
北京市丰台区	北京市【豐】【臺】區
电视节目制作	電視節目【制】作
很困难的事情	很【困】難的事情
是发展中国家	是【發】展中國家
预防控制中心	預防控【制】中心
移动用户发送	移動用戶【發】送
的情况下才能	的情況下【才】能
到底是干什么	到底是【幹】什麼
管理体制改革	管理體【制】改革
江苏省南京市	江【蘇】省南京市
今后一个时期	今【後】一個時期
南京师范大学	南京師【範】大學
我才发现自己	我【才】【發】現自己
西部大开发的	西部大開【發】的
根据实际需要	根【據】實際需要
最后一次机会	最【後】一次機會
华南师范大学	華南師【範】大學
胡锦涛总书记	【胡】錦濤總書記
国际广播电台	國際廣播電【臺】
进行了深入的	進行【了】深入的
我看见了一个	我看見【了】一個
本科以上学历	本科以上學【歷】
党中央国务院	【黨】中央國務院
党的路线方针	【黨】的路線方【針】
经济技术开发	經濟技【術】開【發】
国家标准规定	國家標【準】規定
的发展奠定了	的【發】展奠定【了】
的投资回报率	的投資【回】報率
自己的房间里	自己的房間【里】
目的只有一个	目的【只】有一個
陕西师范大学	陝西師【範】大學
海淀区中关村	海【澱】區中關村
进行了广泛的	進行【了】廣泛的
以下几个方面	以下【幾】個方【面】
国务院批准的	國務院批【準】的
主管部门应当	主管部門應【當】
路线方针政策	路線方【針】政策
出现质量问题	【出】現質量問題
另一方面则是	另一方【面】則是
山东工艺美术	山東工藝美【術】
党的执政能力	【黨】的執政能力
发达国家相比	【發】達國家相比
出的对话框中	【出】的對話框中
最新数据显示	最新數【據】顯示
专业技术资格	專業技【術】資格
全面贯彻落实	全【面】貫徹落實
应当按照规定	應【當】按照規定
采取什么样的	【採】取什麼樣的
现代教育技术	現代教育技【術】
身份证复印件	身份證【復】印件
人民政府批准	人民政府批【準】
世界上有一种	世界上有一【種】
房地产开发商	房地產開【發】商
通过各种渠道	通過各【種】渠道
一发不可收拾	一【發】不可收拾
负责人参加了	負責人【參】加【了】
各项规章制度	各項規章【制】度
各级领导干部	各級領導【幹】部
的事情太多了	的事情太多【了】
发展社会主义	【發】展社會主義
全国人大代表	全國人大代【表】
唯一不同的是	唯一不【同】的是
最突出的特点	最突【出】的特點
并不一定就是	【並】不一定就是
加强党的执政	加強【黨】的執政
胡锦涛同志为	【胡】錦濤【同】【志】爲
奠定了坚实的	奠定【了】堅實的
建筑工程学院	建【築】工程學院
后来我才发现	【後】來我【才】【發】現
干部队伍建设	【幹】部隊伍建設
豪杰超级解霸	豪【傑】超級解霸
为什么会出现	爲什麼會【出】現
我的朋友面前	我的朋友【面】前
经国务院批准	經國務院批【準】
数据仅供参考	數【據】僅供【參】考
理论联系实际	理論聯【係】實際
经济发展迅速	經濟【發】展迅速
科学技术发展	科學技【術】【發】展
我的时间到了	我的時間到【了】
提供了有力的	提供【了】有力的
参拜靖国神社	【參】拜靖國神社
外交部发言人	外交部【發】言人
做好心理准备	做好心理【準】備
现在怎么样了	現在怎麼樣【了】
主管部门批准	主管部門批【準】
以科学发展观	以科學【發】展觀
内容管理系统	內容管理【係】統
这是一种非常	這是一【種】非常
统计数据显示	統計數【據】顯示
食品药品监督	食品【藥】品監督
成为一种时尚	成爲一【種】時尚
先锋模范作用	先鋒模【範】作用
市场的占有率	市場的【佔】有率
农村经济发展	農村經濟【發】展
社会保障体系	社會保障體【係】
了马克思主义	【了】馬【克】思主義
发现问题及时	【發】現問題及時
地理信息系统	地理信息【係】統
使出浑身解数	使【出】渾身解數
有限公司签署	有限公司【籖】署
在全市范围内	在全市【範】圍內
一切都过去了	一切都過去【了】
到了很多东西	到【了】很多東西
根据有关部门	根【據】有關部門
经济快速发展	經濟快速【發】展
阿里巴巴集团	阿【里】巴巴集【團】
人才队伍建设	人【才】隊伍建設
艺术有限公司	藝【術】有限公司
新闻发布会上	新聞【發】【佈】會上
国家标准要求	國家標【準】要求
国家开发银行	國家開【發】銀行
网站管理系统	網站管理【係】統
上海师范大学	上海師【範】大學
仪表有限公司	儀【表】有限公司
国民经济发展	國民經濟【發】展
网页设计制作	網頁設計【制】作
快速健康发展	快速健康【發】展
经济发展水平	經濟【發】展水平
让人不寒而栗	讓人不寒而【慄】
有关部门应当	有關部門應【當】
团队合作精神	【團】隊合作精神
同级人民政府	【同】級人民政府
公司注册资本	公司【注】冊資本
上海浦东发展	上海浦東【發】展
持续健康发展	持續健康【發】展
里面还有一个	【里】【面】還有一個
别有用心的人	【別】有用心的人
并没有因此而	【並】沒有因此而
几乎可以肯定	【幾】乎可以肯定
发脾气的时候	【發】脾氣的時候
中医药管理局	中醫【藥】管理局
社会事业发展	社會事業【發】展
代表大会代表	代【表】大會代【表】
发展势头良好	【發】展勢頭良好
不好意思说了	不好意思說【了】
职业技术学校	職業技【術】學校
笔记本台式机	筆記本【臺】式機
遇到这种情况	遇到這【種】情況
非公有制经济	非公有【制】經濟
取得了一定的	取得【了】一定的
也是最后一次	也是最【後】一次
造成严重后果	造成嚴重【後】果
是非常困难的	是非常【困】難的
随着科学技术	隨著科學技【術】
对马克思主义	對馬【克】思主義
科学发展观和	科學【發】展觀和
我就没办法了	我就沒辦法【了】
社会协调发展	社會協調【發】展
质量保证体系	質量保證體【係】
日报报业集团	日報報業集【團】
乌兹别克斯坦	烏茲【別】【克】斯坦
社会保障制度	社會保障【制】度
今后一段时间	今【後】一段時間
语言表达能力	語言【表】達能力
根据工作需要	根【據】工作需要
没什么大不了	沒什麼大不【了】
人民法院应当	人民法院應【當】
一些发达国家	一些【發】達國家
技术研究中心	技【術】研究中心
党员领导干部	【黨】員領導【幹】部
广州市白云区	廣州市白【雲】區
企业会计准则	企業會計【準】則
防盗报警系统	防盜報警【係】統
和可持续发展	和可持續【發】展
开展丰富多彩	開展【豐】富多【彩】
的发展起到了	的【發】展起到【了】
出台了一系列	【出】【臺】【了】一【係】列
手机响了起来	手機響【了】起來
联通用户发送	聯通用戶【發】送
专业技术职务	專業技【術】職務
辽宁省沈阳市	遼寧省【瀋】陽市
力气都没有了	力氣都沒有【了】
发表重要讲话	【發】【表】重要講話
遍布全国各地	遍【佈】全國各地
只属于自己的	【只】屬於自己的
去年同期增加	去年【同】期增加
历史文化名城	【歷】史文化名城
中国福利彩票	中國福利【彩】票
吊销营业执照	【吊】銷營業執照
中枢神经系统	中樞神經【係】統
信息产业发展	信息產業【發】展
人才交流中心	人【才】交流中心
令人不寒而栗	令人不寒而【慄】
第一次见面的	第一次見【面】的
成都打折机票	成都打【折】機票
云南省昆明市	【雲】南省昆明市
中小企业发展	中小企業【發】展
管理规章制度	管理規章【制】度
两种截然不同	兩【種】截然不【同】
沈阳市沈河区	【瀋】陽市【瀋】河區
在同等条件下	在【同】等條件下
因为我学会了	因爲我學會【了】
坚持科学发展	堅持科學【發】展
注册香港公司	【注】冊香港公司
当地经济发展	【當】地經濟【發】展
发生了根本性	【發】生【了】根本性
建筑科技大学	建【築】科技大學
我国经济发展	我國經濟【發】展
提出一个问题	提【出】一個問題
无论发生什么	無論【發】生什麼
起到了很好的	起到【了】很好的
大学艺术学院	大學藝【術】學院
进一步加大了	進一步加大【了】
了科学发展观	【了】科學【發】展觀
经济高速发展	經濟高速【發】展
发现自己原来	【發】現自己原來
只能说对不起	【只】能說對不起
苏州工业园区	【蘇】州工業園區
据国家统计局	【據】國家統計局
西方发达国家	西方【發】達國家
在讲话中指出	在講話中指【出】
技术服务中心	技【術】服務中心
发送手机短信	【發】送手機短信
各项准备工作	各項【準】備工作
面对我的人生	【面】對我的人生
否则后果自负	否則【後】果自負
中国电信集团	中國電信集【團】
有关部门制定	有關部門【制】定
异曲同工之妙	異【曲】【同】工之妙
我也差不多了	我也差不多【了】
问题比较突出	問題比較突【出】
积累了丰富的	積纍【了】【豐】富的
经济技术合作	經濟技【術】合作
制衣有限公司	【制】衣有限公司
后果不堪设想	【後】果不堪設想
人事制度改革	人事【制】度改革
建筑装饰材料	建【築】裝飾材料
发展中的问题	【發】展中的問題
形成了鲜明的	形成【了】鮮明的
信息发布系统	信息【發】【佈】【係】統
发挥着越来越	【發】揮著越來越
互联网发展的	互聯網【發】展的
职业生涯规划	職業生涯規【劃】
安全管理制度	安全管理【制】度
促进经济发展	促進經濟【發】展
最新统计数据	最新統計數【據】
已经不记得了	已經不記得【了】
党的建设新的	【黨】的建設新的
已经不可能了	已經不可能【了】
有限公司宣布	有限公司宣【佈】
什么都不说了	什麼都不說【了】
集团副总经理	集【團】副總經理
更多精彩图片	更多精【彩】圖片
企业管理制度	企業管理【制】度
注册表编辑器	【注】冊【表】編輯器
与可持续发展	與可持續【發】展
在全国范围内	在全國【範】圍內
与研究出版社	與研究【出】版社
计划生育工作	計【劃】生育工作
科学技术工业	科學技【術】工業
的进一步发展	的進一步【發】展
做一个幸福的	做一個【幸】福的
当地人民政府	【當】地人民政府
医药有限公司	醫【藥】有限公司
暴露出的问题	暴露【出】的問題
政治体制改革	政治體【制】改革
也不会再回来	也不會再【回】來
通过多种方式	通過多【種】方式
起到了积极的	起到【了】積極的
异口同声地说	異口【同】聲地說
计划经济体制	計【劃】經濟體【制】
浙江省台州市	浙江省【臺】州市
打下了坚实的	打下【了】堅實的
什么也不说了	什麼也不說【了】
部门提出申请	部門提【出】申請
房屋租赁合同	房屋租賃合【同】
的马克思主义	的馬【克】思主義
提出书面申请	提【出】書【面】申請
北京打折机票	北京打【折】機票
信息系统安全	信息【係】統安全
专业技术人才	專業技【術】人【才】
回头看看自己	【回】頭看看自己
向左走向右走	【向】左走【向】右走
对我来说只是	對我來說【只】是
最后一次见面	最【後】一次見【面】
报国务院批准	報國務院批【準】
面临着巨大的	【面】臨著巨大的
需要注意的是	需要【注】意的是
历史文化底蕴	【歷】史文化底蘊
人的全面发展	人的全【面】【發】展
好了我要走了	好【了】我要走【了】
俄罗斯的关系	俄羅斯的關【係】
没有发现任何	沒有【發】現任何
必须严格执行	必【須】嚴格執行
东北师范大学	東北師【範】大學
必须严格遵守	必【須】嚴格遵守
的时候才想起	的時候【才】想起
引起了强烈的	引起【了】強烈的
科学发展观为	科學【發】展觀爲
前期准备工作	前期【準】備工作
上海打折机票	上海打【折】機票
眼睛里充满了	眼睛【里】充滿【了】
心里在想什么	心【里】在想什麼
合作医疗制度	合作醫療【制】度
取得了阶段性	取得【了】階段性
房屋出租信息	房屋【出】租信息
引人注意的是	引人【注】意的是
出现的新情况	【出】現的新情況
在一个房间里	在一個房間【里】
彩信铃声下载	【彩】信鈴聲下載
电子商务发展	電子商務【發】展
我的心里只有	我的心【里】【只】有
现代信息技术	現代信息技【術】
研究人员发现	研究人員【發】現
可能只是一个	可能【只】是一個
信托投资公司	信【托】投資公司
当你孤单你会	【當】你孤單你會
行政管理体制	行政管理體【制】
大型企业集团	大型企業集【團】
中表现出来的	中【表】現【出】來的
根据有关规定	根【據】有關規定
不断发展壮大	不斷【發】展壯大
积极采取措施	積極【採】取措施
钢之炼金术师	鋼之【煉】金【術】師
发挥重要作用	【發】揮重要作用
进一步提高了	進一步提高【了】
排名不分先后	排名不分先【後】
人民法院作出	人民法院作【出】
也不知道过了	也不知道過【了】
食品药品监管	食品【藥】品監管
卫星定位系统	衛星定位【係】統
政府采购中心	政府【採】購中心
视频会议系统	視頻會議【係】統
进行数据传输	進行數【據】傳輸
可以随心所欲	可以隨心所【欲】
符合国家标准	符合國家標【準】
开发区管委会	開【發】區管委會
有关人士表示	有關人士【表】示
江苏省无锡市	江【蘇】省無錫市
城市总体规划	城市總體規【劃】
有一种爱叫做	有一【種】愛叫做
中国美术学院	中國美【術】學院
装备制造业的	裝備【制】造業的
广州打折机票	廣州打【折】機票
产业健康发展	產業健康【發】展
根据具体情况	根【據】具體情況
用人单位应当	用人單位應【當】
手机彩铃下载	手機【彩】鈴下載
全国代表大会	全國代【表】大會
等方面进行了	等方【面】進行【了】
参加了学校的	【參】加【了】學校的
湖南师范大学	湖南師【範】大學
民营经济发展	民營經濟【發】展
到底发生什么	到底【發】生什麼
中央领导同志	中央領導【同】【志】
我学会了很多	我學會【了】很多
财务管理制度	財務管理【制】度
为了一个男人	爲【了】一個男人
签订劳动合同	【籖】訂勞動合【同】
健康快速发展	健康快速【發】展
的历史进程中	的【歷】史進程中
党政领导干部	【黨】政領導【幹】部
还有几个小时	還有【幾】個小時
职业技术教育	職業技【術】教育
技术资格考试	技【術】資格考試
有什么区别吗	有什麼區【別】嗎
生活保障制度	生活保障【制】度
科学技术协会	科學技【術】協會
制定切实可行	【制】定切實可行
区域经济发展	區域經濟【發】展
的一个角落里	的一個角落【里】
现在只有一个	現在【只】有一個
新中国成立后	新中國成立【後】
采取多种形式	【採】取多【種】形式
奠定了良好的	奠定【了】良好的
企业技术创新	企業技【術】創新
不食人间烟火	不食人間【煙】火
发现自己根本	【發】現自己根本
奥林匹克花园	奧林匹【克】花園
的时候遇到了	的時候遇到【了】
就是我的幸福	就是我的【幸】福
是马克思主义	是馬【克】思主義
这几天一直在	這【幾】天一直在
我又何尝不是	我又何【嘗】不是
不管发生什么	不管【發】生什麼
一开始就注定	一開始就【注】定
未来发展方向	未來【發】展方【向】
的不正当竞争	的不正【當】競爭
新的历史起点	新的【歷】史起點
欠发达地区的	欠【發】達地區的
不干净的东西	不【幹】凈的東西
需要特别注意	需要特【別】【注】意
何尝不是这样	何【嘗】不是這樣
等方面存在的	等方【面】存在的
遍布世界各地	遍【佈】世界各地
那我没办法了	那我沒辦法【了】
的一个里程碑	的一個【里】程碑
江苏省苏州市	江【蘇】省【蘇】州市
由于种种原因	由於【種】【種】原因
职工代表大会	職工代【表】大會
同年同月同日	【同】年【同】月【同】日
辽宁师范大学	遼寧師【範】大學
格外引人注目	格外引人【注】目
经济发达地区	經濟【發】達地區
未来发展趋势	未來【發】展趨勢
是中央电视台	是中央電視【臺】
有着千丝万缕	有著【千】絲【萬】縷
只是没有想到	【只】是沒有想到
大家一致认为	大家一【致】認爲
做出突出贡献	做【出】突【出】貢獻
发现自己变得	【發】現自己變得
农业技术推广	農業技【術】推廣
得到有效控制	得到有效控【制】
为什么不回家	爲什麼不【回】家
发展高新技术	【發】展高新技【術】
达到国家标准	達到國家標【準】
注意劳逸结合	【注】意勞逸結合
社会广泛关注	社會廣泛關【注】
成立了专门的	成立【了】專門的
占有一席之地	【佔】有一席之地
所以我学会了	所以我學會【了】
我已经决定了	我已經決定【了】
发展循环经济	【發】展循環經濟
面向社会公开	【面】【向】社會公開
给大家带来了	給大家帶來【了】
当地政府部门	【當】地政府部門
了不好意思啊	【了】不好意思啊
我心里只有你	我心【里】【只】有你
提升品牌形象	提【升】品牌形象
给了我很大的	給【了】我很大的
代表大会制度	代【表】大會【制】度
十万个为什么	十【萬】個爲什麼
农业综合开发	農業綜合開【發】
首都师范大学	首都師【範】大學
必须高度重视	必【須】高度重視
到底要干什么	到底要【幹】什麼
国务院发布的	國務院【發】【佈】的
不到最后一刻	不到最【後】一刻
机械设计制造	機械設計【制】造
提供了足够的	提供【了】足夠的
自助建站系统	自助建站【係】統
我不知道以后	我不知道以【後】
原因只有一个	原因【只】有一個
师范高等专科	師【範】高等專科
研究结果表明	研究結果【表】明
福建师范大学	福建師【範】大學
注意以下几点	【注】意以下【幾】點
大家共同努力	大家共【同】努力
实行计划生育	實行計【劃】生育
不知道去哪里	不知道去哪【里】
千万不要忘记	【千】【萬】不要忘記
的发展和进步	的【發】展和進步
不想说什么了	不想說什麼【了】
全球定位系统	全球定位【係】統
进一步增强了	進一步增強【了】
发生重大变化	【發】生重大變化
工艺美术学院	工藝美【術】學院
最低工资标准	最低工資標【準】
有一种淡淡的	有一【種】淡淡的
提供了可靠的	提供【了】可靠的
只有一小部分	【只】有一小部分
按照合同约定	按照合【同】約定
企业发展战略	企業【發】展戰略
制冷空调设备	【制】冷空調設備
是第一次参加	是第一次【參】加
一种前所未有	一【種】前所未有
国家发改委和	國家【發】改委和
有相当一部分	有相【當】一部分
全面质量管理	全【面】質量管理
什么都过去了	什麼都過去【了】
资本市场发展	資本市場【發】展
发现自己居然	【發】現自己居然
权利义务关系	權利義務關【係】
信息仅供参考	信息僅供【參】考
沈阳市和平区	【瀋】陽市和平區
的党中央周围	的【黨】中央【周】圍
企业会计制度	企業會計【制】度
科学的发展观	科學的【發】展觀
利害关系人与	利害關【係】人與
以上领导干部	以上領導【幹】部
建筑安装工程	建【築】安裝工程
走可持续发展	走可持續【發】展
几乎每天都会	【幾】乎每天都會
提供了宝贵的	提供【了】寶貴的
十大杰出青年	十大【傑】【出】青年
给了我黑色的	給【了】我黑色的
参与国际竞争	【參】與國際競爭
公司注册资金	公司【注】冊資金
根据法律规定	根【據】法律規定
中央美术学院	中央美【術】學院
自己只不过是	自己【只】不過是
奥运场馆周边	奧運場館【周】邊
住房制度改革	住房【制】度改革
农副产品批发	農副產品批【發】
大家千万不要	大家【千】【萬】不要
推动科学发展	推動科學【發】展
过的怎么样了	過的怎麼樣【了】
发现自己好像	【發】現自己好像
没有什么关系	沒有什麼關【係】
取得了很好的	取得【了】很好的
然后重新启动	然【後】重新啓動
的情况下发生	的情況下【發】生
特别是青少年	特【別】是青少年
被认为是一种	被認爲是一【種】
市场发展趋势	市場【發】展趨勢
在全省范围内	在全省【範】圍內
合作伙伴提供	合作【夥】伴提供
历史遗留问题	【歷】史遺留問題
科技发展中心	科技【發】展中心
必须严格按照	必【須】嚴格按照
怎么还没回来	怎麼還沒【回】來
法院强制执行	法院強【制】執行
今后一段时期	今【後】一段時期
那就不知道了	那就不知道【了】
歌曲在线试听	歌【曲】在線試聽
充分发挥市场	充分【發】揮市場
骨子里的东西	骨子【里】的東西
优秀共产党员	優秀共產【黨】員
经济协调发展	經濟協調【發】展
心里是怎么想	心【里】是怎麼想
世界经济发展	世界經濟【發】展
为了安全起见	爲【了】安全起見
信息发布软件	信息【發】【佈】軟件
一个新的台阶	一個新的【臺】階
成为一种趋势	成爲一【種】趨勢
环境管理体系	環境管理體【係】
只是一个开始	【只】是一個開始
马上就要到了	馬上就要到【了】
真的不理我了	真的不理我【了】
文化产业发展	文化產業【發】展
巩固党的执政	鞏固【黨】的執政
固定资产折旧	固定資產【折】舊
另一方面就是	另一方【面】就是
中国出口商品	中國【出】口商品
留下了深刻的	留下【了】深刻的
希望大家以后	希望大家以【後】
在这种情况下	在這【種】情況下
互联网的发展	互聯網的【發】展
经费保障机制	經費保障機【制】
来自四面八方	來自四【面】八方
销售管理系统	銷售管理【係】統
不知道以后的	不知道以【後】的
医疗保险制度	醫療保險【制】度
科学技术进步	科學技【術】進步
自己与众不同	自己與眾不【同】
地方经济发展	地方經濟【發】展
高新技术成果	高新技【術】成果
我不记得了啊	我不記得【了】啊
发挥积极作用	【發】揮積極作用
各级党政机关	各級【黨】政機關
我在心里默默	我在心【里】默默
人力资源规划	人力資源規【劃】
中国网络游戏	中國網絡【遊】戲
这种感觉真好	這【種】感覺真好
就已经决定了	就已經決定【了】
国家科学技术	國家科學技【術】
现代科学技术	現代科學技【術】
建立合作关系	建立合作關【係】
发生这种事情	【發】生這【種】事情
在中央电视台	在中央電視【臺】
作出行政处罚	作【出】行政處罰
发挥主导作用	【發】揮主導作用
出口退税政策	【出】口退稅政策
系统的安全性	【係】統的安全性
走向国际市场	走【向】國際市場
这样才能达到	這樣【才】能達到
入党积极分子	入【黨】積極分子
外汇投资公司	外【匯】投資公司
广泛征求意见	廣泛【徵】求意見
社会发展规划	社會【發】展規【劃】
更多精彩内容	更多精【彩】內容
掌握核心技术	掌握核心技【術】
行业健康发展	行業健康【發】展
你现在在哪里	你現在在哪【里】
气喘吁吁地说	氣喘【籲】【籲】地說
核心价值体系	核心價值體【係】
微微点了点头	微微點【了】點頭
博鳌亚洲论坛	博鰲亞洲論【壇】
最后还是选择	最【後】還是選擇
柴油发电机组	柴油【發】電機組
提出具体要求	提【出】具體要求
千万不要为了	【千】【萬】不要爲【了】
沙发上看电视	沙【發】上看電視
你现在才知道	你現在【才】知道
以前不一样了	以前不一樣【了】
国防科学技术	國防科學技【術】
不了多长时间	不【了】多長時間
何尝不是一件	何【嘗】不是一件
经济发展速度	經濟【發】展速度
高新技术企业	高新技【術】企業
有什么关系吗	有什麼關【係】嗎
住宅建筑面积	住宅建【築】【面】積
电子信息技术	電子信息技【術】
什么时候才能	什麼時候【才】能
总书记胡锦涛	總書記【胡】錦濤
形成了独特的	形成【了】獨特的
县域经济发展	縣域經濟【發】展
别有一番情趣	【別】有一番情趣
作出明确规定	作【出】明確規定
可持续发展的	可持續【發】展的
一个重要方面	一個重要方【面】
发生交通事故	【發】生交通事故
信息系统建设	信息【係】統建設
公司自主研发	公司自主研【發】
外贸服装批发	外貿服裝批【發】
加强制度建设	加強【制】度建設
第一次出现在	第一次【出】現在
提供科学依据	提供科學依【據】
怎么样才能让	怎麼樣【才】能讓
矿产资源开发	礦產資源開【發】
进行了详细的	進行【了】詳細的
人体艺术摄影	人體藝【術】攝影
发展的基础上	【發】展的基礎上
为了满足自己	爲【了】滿足自己
西南师范大学	西南師【範】大學
经济数据显示	經濟數【據】顯示
技术改造项目	技【術】改造項目
外出务工人员	外【出】務工人員
相当一段时间	相【當】一段時間
水土流失面积	水土流失【面】積
责任追究制度	責任追究【制】度
有限公司开发	有限公司開【發】
最大输出功率	最大輸【出】功率
法律若干问题	法律若【幹】問題
优秀旅游城市	優秀旅【遊】城市
今天就到这里	今天就到這【里】
解决不了问题	解決不【了】問題
我们不可能了	我們不可能【了】
现在知道了吧	現在知道【了】吧
我忘记了自己	我忘記【了】自己
养老保险制度	養老保險【制】度
债券市场发展	債券市場【發】展
我已经忘记了	我已經忘記【了】
存款准备金率	存款【準】備金率
依据有关规定	依【據】有關規定
咨询服务系统	咨詢服務【係】統
继续向前走去	繼續【向】前走去
国民经济体系	國民經濟體【係】
规范矿产资源	規【範】礦產資源
得到充分发挥	得到充分【發】揮
具有相当大的	具有相【當】大的
不好意思了啊	不好意思【了】啊
党性分析材料	【黨】性分析材料
国际信托投资	國際信【托】投資
只有这个时候	【只】有這個時候
分配制度改革	分配【制】度改革
一切都是为了	一切都是爲【了】
网络操作系统	網絡操作【係】統
发出紧急通知	【發】【出】緊急通知
解除劳动合同	解除勞動合【同】
也不知道哪里	也不知道哪【里】
现在只是一个	現在【只】是一個
心里很不舒服	心【里】很不舒服
注册码注册机	【注】冊碼【注】冊機
即时战略游戏	即時戰略【遊】戲
团结就是力量	【團】結就是力量
中共中央党校	中共中央【黨】校
了我也不知道	【了】我也不知道
打下了良好的	打下【了】良好的
各项方针政策	各項方【針】政策
针对这些问题	【針】對這些問題
在这个社会里	在這個社會【里】
采取措施防止	【採】取措施防止
你都不理我了	你都不理我【了】
可编程控制器	可編程控【制】器
的影响并不大	的影響【並】不大
昨天记者采访	昨天記者【採】訪
引起了广泛的	引起【了】廣泛的
进行了全面的	進行【了】全【面】的
技术创新能力	技【術】創新能力
总是说不出口	總是說不【出】口
经济发展战略	經濟【發】展戰略
根据不同情况	根【據】不【同】情況
电子科技集团	電子科技集【團】
肖申克的救赎	肖申【克】的救贖
出租车司机的	【出】租車司機的
实际控制人的	實際控【制】人的
达到了惊人的	達到【了】驚人的
中专以上学历	中專以上學【歷】
一切只不过是	一切【只】不過是
充分发挥自身	充分【發】揮自身
说不出一句话	說不【出】一句話
中国新闻周刊	中國新聞【周】刊
不知道干什么	不知道【幹】什麼
手机游戏下载	手機【遊】戲下載
审批制度改革	審批【制】度改革
知道就可以了	知道就可以【了】
进行了认真的	進行【了】認真的
取得了较好的	取得【了】較好的
党和国家事业	【黨】和國家事業
这个世界只有	這個世界【只】有
科学技术研究	科學技【術】研究
及时采取措施	及時【採】取措施
产权制度改革	產權【制】度改革
天有不测风云	天有不測風【雲】
有关这方面的	有關這方【面】的
我只想说一句	我【只】想說一句
发展专项资金	【發】展專項資金
党的基层组织	【黨】的基層組織
有色金属冶炼	有色金屬冶【煉】
她有男朋友了	她有男朋友【了】
据国家发改委	【據】國家【發】改委
不知道以后会	不知道以【後】會
这样一个平台	這樣一個平【臺】
另外一个同学	另外一個【同】學
国有企业改制	國有企業改【制】
出现在我们的	【出】現在我們的
网络游戏产品	網絡【遊】戲產品
党的基本路线	【黨】的基本路線
呼吸系统疾病	呼吸【係】統疾病
促进共同发展	促進共【同】【發】展
有很多种方式	有很多【種】方式
接受媒体采访	接受媒體【採】訪
先天性心脏病	先天性心【髒】病
为进一步规范	爲進一步規【範】
一个人的精彩	一個人的精【彩】
中国网通集团	中國網通集【團】
蔬菜批发市场	蔬菜批【發】市場
的一个转折点	的一個轉【折】點
什么时候回家	什麼時候【回】家
马克思恩格斯	馬【克】思恩格斯
这方面的工作	這方【面】的工作
志愿者服务队	【志】願者服務隊
保持高度一致	保持高度一【致】
几乎是不可能	【幾】乎是不可能
但是千万不要	但是【千】【萬】不要
当爱已成往事	【當】愛已成往事
四川师范大学	四川師【範】大學
和我在一起了	和我在一起【了】
河北师范大学	河北師【範】大學
经营管理人才	經營管理人【才】
两个完全不同	兩個完全不【同】
几乎已经成为	【幾】乎已經成爲
本身就是一种	本身就是一【種】
在一起度过了	在一起度過【了】
在中国共产党	在中國共產【黨】
会计专业技术	會計專業技【術】
技术发展趋势	技【術】【發】展趨勢
稳定健康发展	穩定健康【發】展
江西师范大学	江西師【範】大學
干部教育培训	【幹】部教育培訓
每当这个时候	每【當】這個時候
紧随其后的是	緊隨其【後】的是
有发展前途的	有【發】展前途的
外汇管理部门	外【匯】管理部門
真实地反映了	真實地反映【了】
去面对自己的	去【面】對自己的
你刚才不是说	你剛【才】不是說
未尝不是一种	未【嘗】不是一【種】
一天天过去了	一天天過去【了】
适用法律若干	適用法律若【幹】
战略伙伴关系	戰略【夥】伴關【係】
股东大会批准	股東大會批【準】
打开控制面板	打開控【制】【面】【板】
消息人士表示	消息人士【表】示
摇身一变成了	搖身一變成【了】
国家发改委等	國家【發】改委等
集团有限责任	集【團】有限責任
唐伯虎点秋香	唐伯虎點【秋】香
干部选拔任用	【幹】部選拔任用
用科学发展观	用科學【發】展觀
家里还有一个	家【里】還有一個
带来负面影响	帶來負【面】影響
非公有制企业	非公有【制】企業
当地实际情况	【當】地實際情況
我就不清楚了	我就不清楚【了】
建筑材料工业	建【築】材料工業
这说明了什么	這說明【了】什麼
有点不记得了	有點不記得【了】
国际关系学院	國際關【係】學院
的科学发展观	的科學【發】展觀
法制宣传教育	法【制】宣傳教育
没有发生任何	沒有【發】生任何
知道自己错了	知道自己錯【了】
领导干部进行	領導【幹】部進行
也是一种境界	也是一【種】境界
后来发现自己	【後】來【發】現自己
这方面的知识	這方【面】的知識
家里打个电话	家【里】打個電話
大学毕业以后	大學畢業以【後】
建筑工程公司	建【築】工程公司
协调健康发展	協調健康【發】展
有关部门提出	有關部門提【出】
业内人士指出	業內人士指【出】
杭州打折机票	杭州打【折】機票
太平洋游戏网	太平洋【遊】戲網
现象时有发生	現象時有【發】生
参加社会实践	【參】加社會實踐
根据市场需求	根【據】市場需求
高新技术产业	高新技【術】產業
分析人士指出	分析人士指【出】
发展有限责任	【發】展有限責任
在国际舞台上	在國際舞【臺】上
服装批发市场	服裝批【發】市場
出现在你身边	【出】現在你身邊
自动控制系统	自動控【制】【係】統
未尝不是一件	未【嘗】不是一件
就这么过去了	就這麼過去【了】
由中央电视台	由中央電視【臺】
不出意外的话	不【出】意外的話
研究生毕业后	研究生畢業【後】
面向对象编程	【面】【向】對象編程
已经有了一些	已經有【了】一些
等方面的情况	等方【面】的情況
提出这样一个	提【出】這樣一個
系统中的应用	【係】統中的應用
以不变应万变	以不變應【萬】變
文化体制改革	文化體【制】改革
只是一个平凡	【只】是一個平凡
那你想干什么	那你想【幹】什麼
酒店管理系统	酒店管理【係】統
发展职业教育	【發】展職業教育
在北京举行了	在北京舉行【了】
提出了一系列	提【出】【了】一【係】列
行政审批制度	行政審批【制】度
投资体制改革	投資體【制】改革
部分计划生育	部分計【劃】生育
最珍贵的回忆	最珍貴的【回】憶
千万不要小看	【千】【萬】不要小看
只有你想不到	【只】有你想不到
升级杀毒软件	【升】級殺毒軟件
发自内心的爱	【發】自內心的愛
升起来的时候	【升】起來的時候
等方面的问题	等方【面】的問題
硬盘数据恢复	硬盤數【據】恢【復】
平板电视市场	平【板】電視市場
等方面取得了	等方【面】取得【了】
只是微微一笑	【只】是微微一笑
我要回去了啊	我要【回】去【了】啊
关系人民群众	關【係】人民群眾
最后我们还是	最【後】我們還是
浙江师范大学	浙江師【範】大學
软件开发人员	軟件開【發】人員
对自己的一种	對自己的一【種】
信息技术课程	信息技【術】課程
中国游戏中心	中國【遊】戲中心
监测数据显示	監測數【據】顯示
所以千万不要	所以【千】【萬】不要
预防腐败体系	預防腐敗體【係】
当然还有很多	【當】然還有很多
要从实际出发	要從實際【出】【發】
自主研发能力	自主研【發】能力
怎么做才能让	怎麼做【才】能讓
一去不复返了	一去不【復】返【了】
你不理我了呢	你不理我【了】呢
出发点是好的	【出】【發】點是好的
增长率分别为	增長率分【別】爲
党政主要领导	【黨】政主要領導
深深的爱上了	深深的愛上【了】
发扬艰苦奋斗	【發】揚艱苦奮【鬭】
建筑施工企业	建【築】施工企業
时间差不多了	時間差不多【了】
旅游业的发展	旅【遊】業的【發】展
异口同声的说	異口【同】聲的說
利用课余时间	利用課【餘】時間
工作情况汇报	工作情況【匯】報
多年后的今天	多年【後】的今天
可能性并不大	可能性【並】不大
人才服务中心	人【才】服務中心
向记者介绍说	【向】記者介紹說
人才培养模式	人【才】培養模式
目的就是为了	目的就是爲【了】
征地补偿安置	【徵】地補償安置
注意自我保护	【注】意自我保護
已经成为一种	已經成爲一【種】
历史唯物主义	【歷】史唯物主義
制定了严格的	【制】定【了】嚴格的
发现自己已经	【發】現自己已經
公司法人代表	公司法人代【表】
这方面的研究	這方【面】的研究
散发着淡淡的	散【發】著淡淡的
落后生产能力	落【後】生產能力
沈阳市大东区	【瀋】陽市大東區
南京艺术学院	南京藝【術】學院
家庭经济困难	家庭經濟【困】難
纳斯达克上市	納斯達【克】上市
发展的过程中	【發】展的過程中
发现一个问题	【發】現一個問題
一分钟的时间	一分【鍾】的時間
历史文化背景	【歷】史文化背景
药品不良反应	【藥】品不良反應
只有一个理由	【只】有一個理由
新的历史时期	新的【歷】史時期
似乎并不在意	似乎【並】不在意
天上云卷云舒	天上【雲】【捲】【雲】舒
针织有限公司	【針】織有限公司
也没什么区别	也沒什麼區【別】
不了你想要的	不【了】你想要的
用马克思主义	用馬【克】思主義
贷款基准利率	貸款基【準】利率
为了最大限度	爲【了】最大限度
计划生育政策	計【劃】生育政策
现在我长大了	現在我長大【了】
国家承认学历	國家承認學【歷】
平面广告设计	平【面】廣告設計
党纪政纪处分	【黨】紀政紀處分
发展中的重要	【發】展中的重要
扎扎实实做好	【扎】【扎】實實做好
信用体系建设	信用體【係】建設
绝对不会出现	絕對不會【出】現
药品生产企业	【藥】品生產企業
采取多种方式	【採】取多【種】方式
歌词同步显示	歌詞【同】步顯示
进一步的发展	進一步的【發】展
腰椎间盘突出	腰椎間盤突【出】
密切联系群众	密切聯【係】群眾
角色扮演游戏	角色扮演【遊】戲
得到了应有的	得到【了】應有的
国务院法制办	國務院法【制】辦
加强党风廉政	加強【黨】風廉政
接下来发生的	接下來【發】生的
放在更加突出	放在更加突【出】
占据主导地位	【佔】【據】主導地位
不了我对你的	不【了】我對你的
博士后流动站	博士【後】流動站
效果并不明显	效果【並】不明顯
短短的几分钟	短短的【幾】分【鍾】
及时发现问题	及時【發】現問題
山东师范大学	山東師【範】大學
也是一种痛苦	也是一【種】痛苦
要求我们必须	要求我們必【須】
进行了第一次	進行【了】第一次
售后服务体系	售【後】服務體【係】
文字表达能力	文字【表】達能力
科技体制改革	科技體【制】改革
去年同期上涨	去年【同】期上漲
团队协作精神	【團】隊協作精神
并不一定非要	【並】不一定非要
采取补救措施	【採】取補救措施
开始喜欢上了	開始喜歡上【了】
亚洲开发银行	亞洲開【發】銀行
带来了巨大的	帶來【了】巨大的
陌生的城市里	陌生的城市【里】
过上幸福生活	過上【幸】福生活
不管那么多了	不管那麼多【了】
知识产权方面	知識產權方【面】
中央电视台和	中央電視【臺】和
计划生育家庭	計【劃】生育家庭
中发挥更大的	中【發】揮更大的
红军长征胜利	紅軍長【徵】勝利
会有这种感觉	會有這【種】感覺
等方面的工作	等方【面】的工作
国外先进技术	國外先進技【術】
计划执行情况	計【劃】執行情況
内部控制制度	內部控【制】【制】度
极有可能出现	極有可能【出】現
规定的范围内	規定的【範】圍內
发展战略研究	【發】展戰略研究
不知怎么回事	不知怎麼【回】事
没有这方面的	沒有這方【面】的
针对这种情况	【針】對這【種】情況
开发有限责任	開【發】有限責任
已经差不多了	已經差不多【了】
村党支部书记	村【黨】支部書記
文艺复兴时期	文藝【復】興時期
收发电子邮件	收【發】電子郵件
免费游戏下载	免費【遊】戲下載
寻找合作伙伴	尋找合作【夥】伴
回过头来想想	【回】過頭來想想
我的手机响了	我的手機響【了】
果然不出所料	果然不【出】所料
我们必须承认	我們必【須】承認
经历了漫长的	經【歷】【了】漫長的
中国历史文化	中國【歷】史文化
伊拉克前总统	伊拉【克】前總統
形成恶性循环	形成【惡】性循環
家园业主论坛	家園業主論【壇】
突发公共卫生	突【發】公共衛生
现在知道了吗	現在知道【了】嗎
这方面的问题	這方【面】的問題
的可持续发展	的可持續【發】展
发生什么事情	【發】生什麼事情
签署战略合作	【籖】署戰略合作
因为我习惯了	因爲我習慣【了】
揭开神秘面纱	揭開神秘【面】紗
向记者讲述了	【向】記者講述【了】
解除劳动关系	解除勞動關【係】
发生了很大的	【發】生【了】很大的
采取预防措施	【採】取預防措施
从那以后我们	從那以【後】我們
回答这些问题	【回】答這些問題
逐渐成为一种	逐漸成爲一【種】
十届人大代表	十屆人大代【表】
几乎与此同时	【幾】乎與此【同】時
大学生志愿者	大學生【志】願者
失业率控制在	失業率控【制】在
在一段时间里	在一段時間【里】
注册用户请将	【注】冊用戶請將
再也没有联系	再也沒有聯【係】
只有一个答案	【只】有一個答案
说不出的舒服	說不【出】的舒服
成为一种习惯	成爲一【種】習慣
不同于以往的	不【同】於以往的
答案只有一个	答案【只】有一個
阿里巴巴公司	阿【里】巴巴公司
立即采取措施	立即【採】取措施
工作人员发现	工作人員【發】現
工程技术大学	工程技【術】大學
并不知道自己	【並】不知道自己
提出了明确的	提【出】【了】明確的
才是最重要的	【才】是最重要的
直截了当地说	直截【了】【當】地說
金属表面处理	金屬【表】【面】處理
情况并非如此	情況【並】非如此
每个人都必须	每個人都必【須】
环境艺术设计	環境藝【術】設計
的任务完成了	的任務完成【了】
一切只是一个	一切【只】是一個
口头表达能力	口頭【表】達能力
未经书面授权	未經書【面】授權
的事情发生了	的事情【發】生【了】
档案管理系统	檔案管理【係】統
难道就是为了	難道就是爲【了】
突发公共事件	突【發】公共事件
模范带头作用	模【範】帶頭作用
产品生命周期	產品生命【周】期
勇气都没有了	勇氣都沒有【了】
职业教育发展	職業教育【發】展
生活并不需要	生活【並】不需要
漫长的岁月里	漫長的歲月【里】
专业技术职称	專業技【術】職稱
综合管理系统	綜合管理【係】統
有偿使用制度	有償使用【制】度
作出突出贡献	作【出】突【出】貢獻
市政府法制办	市政府法【制】辦
注册上海公司	【注】冊上海公司
只是因为一个	【只】是因爲一個
你怎么来了啊	你怎麼來【了】啊
人大代表建议	人大代【表】建議
投资者可适当	投資者可適【當】
生活中的种种	生活中的【種】【種】
实现科学发展	實現科學【發】展
河南师范大学	河南師【範】大學
提供了广阔的	提供【了】廣闊的
表示衷心感谢	【表】示衷心感謝
房屋买卖合同	房屋買賣合【同】
导弹防御系统	導彈防【御】【係】統
历史上第一个	【歷】史上第一個
引入竞争机制	引入競爭機【制】
又有什么关系	又有什麼關【係】
占有重要地位	【佔】有重要地位
有关专家指出	有關專家指【出】
发现自己变的	【發】現自己變的
过了好久好久	過【了】好久好久
我只能这么说	我【只】能這麼說
汇率形成机制	【匯】率形成機【制】
的发展中国家	的【發】展中國家
有关方面获悉	有關方【面】【獲】悉
卫星导航系统	衛星導航【係】統
电子数据交换	電子數【據】交換
你不理我了吗	你不理我【了】嗎
利用业余时间	利用業【餘】時間
安全防范措施	安全防【範】措施
航天科技集团	航天科技集【團】
作者在两周内	作者在兩【周】內
几个月的时间	【幾】個月的時間
取得了良好的	取得【了】良好的
沈阳工业大学	【瀋】陽工業大學
集中招标采购	集中招標【採】購
不正当竞争法	不正【當】競爭法
最发达的国家	最【發】達的國家
中国足球彩票	中國足球【彩】票
云南师范大学	【雲】南師【範】大學
英雄所见略同	英雄所見略【同】
工资管理系统	工資管理【係】統
的问题进行了	的問題進行【了】
但是我不后悔	但是我不【後】悔
发展农村经济	【發】展農村經濟
提供了大量的	提供【了】大量的
经济发展状况	經濟【發】展狀況
发展是硬道理	【發】展是硬道理
高新技术开发	高新技【術】開【發】
网络游戏厂商	網絡【遊】戲廠商
研究开发中心	研究開【發】中心
最后一轮比赛	最【後】一輪比賽
已经很不错了	已經很不錯【了】
城市规划设计	城市規【劃】設計
只是一个人的	【只】是一個人的
一款网络游戏	一款網絡【遊】戲
向发展中国家	【向】【發】展中國家
改革开放以后	改革開放以【後】
只会说这一句	【只】會說這一句
马克思主义的	馬【克】思主義的
最新网络游戏	最新網絡【遊】戲
起到了很大的	起到【了】很大的
面前人人平等	【面】前人人平等
农业发展银行	農業【發】展銀行
在大学校园里	在大學校園【里】
的时候才发现	的時候【才】【發】現
中国经济周刊	中國經濟【周】刊
签署合作协议	【籖】署合作協議
无形中增加了	無形中增加【了】
阴影中走出来	陰影中走【出】來
海淀区复兴路	海【澱】區【復】興路
药业有限责任	【藥】業有限責任
并没有太多的	【並】沒有太多的
只是知道自己	【只】是知道自己
有关部门获悉	有關部門【獲】悉
几乎所有人都	【幾】乎所有人都
有什么区别啊	有什麼區【別】啊
带来了无限的	帶來【了】無限的
科学发展观的	科學【發】展觀的
到不了的地方	到不【了】的地方
与国家发改委	與國家【發】改委
贝克汉姆夫妇	貝【克】漢姆夫婦
没有什么特别	沒有什麼特【別】
广州美术学院	廣州美【術】學院
建立长效机制	建立長效機【制】
同时在线人数	【同】時在線人數
根据实际情况	根【據】實際情況
打电话过来了	打電話過來【了】
社会主义法制	社會主義法【制】
超过国家标准	超過國家標【準】
西安打折机票	西安打【折】機票
如果不出意外	如果不【出】意外
几乎所有的人	【幾】乎所有的人
里什么都没有	【里】什麼都沒有
提高收费标准	提高收費標【準】
在新的一年里	在新的一年【里】
表达我的心情	【表】達我的心情
缺乏法律依据	缺乏法律依【據】
丰富的维生素	【豐】富的維生素
沉默了一会儿	沉默【了】一會兒
新喀里多尼亚	新喀【里】多尼亞
商标注册申请	商標【注】冊申請
永远只有一个	永遠【只】有一個
游戏中的玩家	【遊】戲中的玩家
活着就是为了	活著就是爲【了】
捷克斯洛伐克	捷【克】斯洛伐【克】
十大风云人物	十大風【雲】人物
佛罗里达州的	佛羅【里】達州的
不断推陈出新	不斷推陳【出】新
图书批发市场	圖書批【發】市場
夫妻共同财产	夫妻共【同】財產
吸烟有害健康	吸【煙】有害健康
表示热烈欢迎	【表】示熱烈歡迎
提前做好准备	提前做好【準】備
循环经济发展	循環經濟【發】展
燃放烟花爆竹	燃放【煙】花爆竹
越来越厉害了	越來越厲害【了】
数据传输速率	數【據】傳輸速率
业余文化生活	業【餘】文化生活
手机网络游戏	手機網絡【遊】戲
喜欢这种感觉	喜歡這【種】感覺
祝你幸福快乐	祝你【幸】福快樂
优秀学生干部	優秀學生【幹】部
师范专科学校	師【範】專科學校
作出更大贡献	作【出】更大貢獻
经济发展中的	經濟【發】展中的
在现实世界里	在現實世界【里】
浩方对战平台	浩方對戰平【臺】
发展的快车道	【發】展的快車道
比上年增长了	比上年增長【了】
有关数据显示	有關數【據】顯示
发展过程中的	【發】展過程中的
在这里你可以	在這【里】你可以
发生了什么事	【發】生【了】什麼事
参加工伤保险	【參】加工傷保險
制定国民经济	【制】定國民經濟
安全管理体系	安全管理體【係】
党的执政地位	【黨】的執政地位
会员代表大会	會員代【表】大會
到底怎么了啊	到底怎麼【了】啊
对中国进行了	對中國進行【了】
变得面目全非	變得【面】目全非
工程施工技术	工程施工技【術】
你的联系方式	你的聯【係】方式
技术师范学院	技【術】師【範】學院
兼容操作系统	兼容操作【係】統
我只想对你说	我【只】想對你說
等发展中国家	等【發】展中國家
现在回过头来	現在【回】過頭來
是不可能的了	是不可能的【了】
没有任何借口	沒有任何【借】口
文化艺术中心	文化藝【術】中心
几秒钟的时间	【幾】秒【鍾】的時間
通过这种方式	通過這【種】方式
只有这样才能	【只】有這樣【才】能
加强党的建设	加強【黨】的建設
显得与众不同	顯得與眾不【同】
引进先进技术	引進先進技【術】
发展中国家的	【發】展中國家的
网页制作教程	網頁【制】作教程
新型建筑材料	新型建【築】材料
技术的基础上	技【術】的基礎上
我第一次参加	我第一次【參】加
国际经济技术	國際經濟技【術】
以下三个方面	以下三個方【面】
财政管理体制	財政管理體【制】
进出口总公司	進【出】口總公司
是用来干什么	是用來【幹】什麼
好久没来这里	好久沒來這【里】
解决台湾问题	解決【臺】灣問題
采取这种方式	【採】取這【種】方式
你已经很久了	你已經很久【了】
国家地理杂志	國家地理雜【志】
摩托罗拉公司	摩【托】羅拉公司
取得了很大的	取得【了】很大的
严厉打击各种	嚴厲打擊各【種】
这方面的情况	這方【面】的情況
怎么会有这种	怎麼會有這【種】
网络游戏点卡	網絡【遊】戲點卡
的生活发生了	的生活【發】生【了】
美国佛罗里达	美國佛羅【里】達
和谐劳动关系	和諧勞動關【係】
在某种程度上	在某【種】程度上
客户管理系统	客戶管理【係】統
面向全国招收	【面】【向】全國招收
我们必须面对	我們必【須】【面】對
回答这个问题	【回】答這個問題
带来了很多的	帶來【了】很多的
高考志愿填报	高考【志】願填報
进一步增加了	進一步增加【了】
为了达到目的	爲【了】達到目的
农村贫困家庭	農村貧【困】家庭
做了这个决定	做【了】這個決定
相信一见钟情	相信一見【鍾】情
图书管理系统	圖書管理【係】統
推动经济发展	推動經濟【發】展
经济的发展和	經濟的【發】展和
一场别开生面	一場【別】開生【面】
可以畅所欲言	可以暢所【欲】言
过了一个星期	過【了】一個星期
上海通用别克	上海通用【別】【克】
经国务院同意	經國務院【同】意
市场上出售的	市場上【出】售的
再也找不到了	再也找不到【了】
安徽师范大学	安徽師【範】大學
中国石化集团	中國石化集【團】
业内人士表示	業內人士【表】示
由于各种原因	由於各【種】原因
带来了极大的	帶來【了】極大的
去想那么多了	去想那麼多【了】
我马上就回去	我馬上就【回】去
会议上了解到	會議上【了】解到
要怎么样才能	要怎麼樣【才】能
历史文化遗产	【歷】史文化遺產
艺术设计专业	藝【術】設計專業
高新技术产品	高新技【術】產品
科学技术奖励	科學技【術】獎勵
和无党派人士	和無【黨】派人士
推出了一系列	推【出】【了】一【係】列
沈阳市皇姑区	【瀋】陽市皇姑區
为了方便大家	爲【了】方便大家
好久不见你了	好久不見你【了】
前的最后一场	前的最【後】一場
迈克尔杰克逊	邁【克】爾【傑】【克】遜
市场上了解到	市場上【了】解到
可以根据自己	可以根【據】自己
在全世界范围	在全世界【範】圍
什么都不要了	什麼都不要【了】
怎样才能找到	怎樣【才】能找到
药品经营企业	【藥】品經營企業
实时操作系统	實時操作【係】統
制定整改措施	【制】定整改措施
因此我们必须	因此我們必【須】
大学本科学历	大學本科學【歷】
种种迹象表明	【種】【種】跡象【表】明
进一步发展的	進一步【發】展的
你已经习惯了	你已經習慣【了】
真的不知道了	真的不知道【了】
中国移动彩铃	中國移動【彩】鈴
移动通信技术	移動通信技【術】
网络游戏市场	網絡【遊】戲市場
没什么了不起	沒什麼【了】不起
去年同期减少	去年【同】期減少
做出巨大贡献	做【出】巨大貢獻
提出解决方案	提【出】解決方案
我们什么关系	我們什麼關【係】
发现我做不到	【發】現我做不到
的眼睛湿润了	的眼睛濕潤【了】
科技师范学院	科技師【範】學院
参加各种活动	【參】加各【種】活動
在北京召开了	在北京召開【了】
总结表彰大会	總結【表】彰大會
体系实施纲要	體【係】實施綱要
提醒大家注意	提醒大家【注】意
有限公司签订	有限公司【籖】訂
昆明打折机票	昆明打【折】機票
几分钟的时间	【幾】分【鍾】的時間
成为当务之急	成爲【當】務之急
只不过是一个	【只】不過是一個
建筑工程质量	建【築】工程質量
提出了更高的	提【出】【了】更高的
教育体制改革	教育體【制】改革
好不容易到了	好不容易到【了】
只剩我一个人	【只】剩我一個人
经济发展模式	經濟【發】展模式
几乎没有任何	【幾】乎沒有任何
徐州师范大学	徐州師【範】大學
只是个普通的	【只】是個普通的
成了这个样子	成【了】這個樣子
免费手机游戏	免費手機【遊】戲
公共服务体系	公共服務體【係】
做出这个决定	做【出】這個決定
公有制为主体	公有【制】爲主體
下面介绍一下	下【面】介紹一下
历史最高水平	【歷】史最高水平
等方面的内容	等方【面】的內容
实际情况出发	實際情況【出】【發】
城乡协调发展	城鄉協調【發】展
在新闻发布会	在新聞【發】【佈】會
生产管理系统	生產管理【係】統
实际上并没有	實際上【並】沒有
发展中的作用	【發】展中的作用
多方面的原因	多方【面】的原因
小时值班制度	小時值班【制】度
参加医疗保险	【參】加醫療保險
一个小时以后	一個小時以【後】
一切只是为了	一切【只】是爲【了】
巡回演唱会的	巡【回】演唱會的
我的心都碎了	我的心都碎【了】
那我就不说了	那我就不說【了】
面临前所未有	【面】臨前所未有
曲阜师范大学	【曲】阜師【範】大學
太阳能电池板	太陽能電池【板】
应对突发事件	應對突【發】事件
欢迎参与讨论	歡迎【參】與討論
权威部门公布	權威部門公【佈】
往事不堪回首	往事不堪【回】首
服务业的发展	服務業的【發】展
动漫产业发展	動漫產業【發】展
几乎没有什么	【幾】乎沒有什麼
情节特别严重	情節特【別】嚴重
姜还是老的辣	【薑】還是老的辣
的时候我心里	的時候我心【里】
按照国家标准	按照國家標【準】
面临的新形势	【面】臨的新形勢
发现了自己的	【發】現【了】自己的
最后冲刺阶段	最【後】【衝】刺階段
汽车产业发展	汽車產業【發】展
社会发展计划	社會【發】展計【劃】
采访中了解到	【採】訪中【了】解到
才发现自己的	【才】【發】現自己的
卫星发射中心	衛星【發】射中心
收入分配制度	收入分配【制】度
基本经济制度	基本經濟【制】度
落后的情况下	落【後】的情況下
采取了一系列	【採】取【了】一【係】列
良好合作关系	良好合作關【係】
过去的一年里	過去的一年【里】
参加社会保险	【參】加社會保險
人民当家作主	人民【當】家作主
提供了良好的	提供【了】良好的
推进党的建设	推進【黨】的建設
对自己的表现	對自己的【表】現
国际标准书号	國際標【準】書號
入侵检测系统	入侵檢測【係】統
视频点播系统	視頻點播【係】統
汽车工业发展	汽車工業【發】展
出现什么问题	【出】現什麼問題
与发展中国家	與【發】展中國家
基层工作经历	基層工作經【歷】
做出更大贡献	做【出】更大貢獻
重庆师范大学	重慶師【範】大學
的时候我发现	的時候我【發】現
最喜欢的歌曲	最喜歡的歌【曲】
人才强国战略	人【才】強國戰略
你一个人出来	你一個人【出】來
因为我在水里	因爲我在水【里】
不说了不说了	不說【了】不說【了】
财务会计制度	財務會計【制】度
系统中计算机	【係】統中計算機
不知道在那里	不知道在那【里】
怎么了为什么	怎麼【了】爲什麼
网络游戏产业	網絡【遊】戲產業
向记者介绍了	【向】記者介紹【了】
取得了突破性	取得【了】突破性
觉得自己老了	覺得自己老【了】
医疗体制改革	醫療體【制】改革
仓库管理系统	倉庫管理【係】統
的中国国民党	的中國國民【黨】
健康稳定发展	健康穩定【發】展
的新闻发布会	的新聞【發】【佈】會
国家经济发展	國家經濟【發】展
现在已经成了	現在已經成【了】
进行面对面的	進行【面】對【面】的
去年同期提高	去年【同】期提高
最后一个学期	最【後】一個學期
申银万国证券	申銀【萬】國證券
证券市场周刊	證券市場【周】刊
美国纳斯达克	美國納斯達【克】
在发展中国家	在【發】展中國家
突发事件应对	突【發】事件應對
当地公安机关	【當】地公安機關
占了绝大多数	【佔】【了】絕大多數
歌曲免费下载	歌【曲】免費下載
目标只有一个	目標【只】有一個
发展的重要性	【發】展的重要性
最后一个环节	最【後】一個環節
我不告诉你了	我不告訴你【了】
引人注目的是	引人【注】目的是
活得不耐烦了	活得不耐煩【了】
科技集团公司	科技集【團】公司
说不出的难过	說不【出】的難過
有一定的关系	有一定的關【係】
奥林匹克竞赛	奧林匹【克】競賽
区域协调发展	區域協調【發】展
全国劳动模范	全國勞動模【範】
干一行爱一行	【幹】一行愛一行
实木复合地板	實木【復】合地【板】
几个小时之后	【幾】個小時之【後】
操作系统软件	操作【係】統軟件
密克罗尼西亚	密【克】羅尼西亞
只能自认倒霉	【只】能自認倒霉
参加全国统一	【參】加全國統一
只是希望大家	【只】是希望大家
英国当地时间	英國【當】地時間
的机会并不多	的機會【並】不多
有效地解决了	有效地解決【了】
质量认证体系	質量認證體【係】
党内监督条例	【黨】內監督條例
新白娘子传奇	新白【娘】子傳奇
和科学发展观	和科學【發】展觀
劳动合同期限	勞動合【同】期限
会在心里默默	會在心【里】默默
痛并快乐着的	痛【並】快樂著的
举了一个例子	舉【了】一個例子
有很大的关系	有很大的關【係】
评价指标体系	評價指標體【係】
电视台主持人	電視【臺】主持人
社会发展中的	社會【發】展中的
开始了自己的	開始【了】自己的
黑色金属冶炼	黑色金屬冶【煉】
美容美发培训	美容美【發】培訓
微软操作系统	微軟操作【係】統
只爱你一个人	【只】愛你一個人
农村贫困人口	農村貧【困】人口
形成机制改革	形成機【制】改革
这是最后一次	這是最【後】一次
成千上万的人	成【千】上【萬】的人
综合布线系统	綜合【佈】線【係】統
在一起经历了	在一起經【歷】【了】
发现自己开始	【發】現自己開始
社会信用体系	社會信用體【係】
沈阳农业大学	【瀋】陽農業大學
只是觉得自己	【只】是覺得自己
旅游景点介绍	旅【遊】景點介紹
提供了丰富的	提供【了】【豐】富的
的时候认识了	的時候認識【了】
系列液晶电视	【係】列液晶電視
单机游戏下载	單機【遊】戲下載
良好发展势头	良好【發】展勢頭
高技术产业化	高技【術】產業化
知道怎么回事	知道怎麼【回】事
几乎一模一样	【幾】乎一模一樣
每一个角落里	每一個角落【里】
数据传输速度	數【據】傳輸速度
无论你在哪里	無論你在哪【里】
部分地区出现	部分地區【出】現
发生过的事情	【發】生過的事情
采用了英特尔	【採】用【了】英特爾
发表学术论文	【發】【表】學【術】論文
收到了很好的	收到【了】很好的
镇党委副书记	鎮【黨】委副書記
积极参与国际	積極【參】與國際
工业集团公司	工業集【團】公司
我们必须学会	我們必【須】學會
消费结构升级	消費結構【升】級
网络游戏玩家	網絡【遊】戲玩家
官方网站公布	官方網站公【佈】
我不是说了吗	我不是說【了】嗎
钓鱼台国宾馆	釣魚【臺】國賓館
就业困难人员	就業【困】難人員
自动对焦系统	自動對焦【係】統
注意到这一点	【注】意到這一點
人体艺术写真	人體藝【術】寫真
进一步强化了	進一步強化【了】
的眼睛注视着	的眼睛【注】視著
以上几个方面	以上【幾】個方【面】
这方面的事情	這方【面】的事情
长效管理机制	長效管理機【制】
公共交通系统	公共交通【係】統
药品安全监管	【藥】品安全監管
成了家常便饭	成【了】家常便飯
我都不知道了	我都不知道【了】
历史上第一次	【歷】史上第一次
建筑装饰设计	建【築】裝飾設計
造成不良后果	造成不良【後】果
医疗卫生体制	醫療衛生體【制】
结果只有一个	結果【只】有一個
官方网站发布	官方網站【發】【佈】
特别是在一些	特【別】是在一些
变得更加复杂	變得更加【復】雜
呈现出良好的	呈現【出】良好的
天津师范大学	天津師【範】大學
生活中的一种	生活中的一【種】
历史上的一个	【歷】史上的一個
因为这是一种	因爲這是一【種】
调查结果表明	調查結果【表】明
福利彩票发行	福利【彩】票【發】行
创造了良好的	創造【了】良好的
奥运会志愿者	奧運會【志】願者
德国法兰克福	德國法蘭【克】福
相同的情况下	相【同】的情況下
小甜甜布兰妮	小甜甜【佈】蘭妮
劳动合同制度	勞動合【同】【制】度
高中以上学历	高中以上學【歷】
出现在自己的	【出】現在自己的
西安美术学院	西安美【術】學院
应用技术学院	應用技【術】學院
山东艺术学院	山東藝【術】學院
图形用户界面	圖形用戶界【面】
我回家的时候	我【回】家的時候
的发展提供了	的【發】展提供【了】
在今后的工作	在今【後】的工作
发展的新阶段	【發】展的新階段
马克思主义者	馬【克】思主義者
不知道怎么才	不知道怎麼【才】
新闻发布会在	新聞【發】【佈】會在
在房地产开发	在房地產開【發】
进行了一系列	進行【了】一【係】列
建立了深厚的	建立【了】深厚的
分别同比增长	分【別】【同】比增長
新会计准则的	新會計【準】則的
我知道我错了	我知道我錯【了】
同比增长超过	【同】比增長超過
共产党领导下	共產【黨】領導下
我终于发现了	我終於【發】現【了】
最后得出结论	最【後】得【出】結論
年度工作计划	年度工作計【劃】
只有我一个人	【只】有我一個人
没有正面回答	沒有正【面】【回】答
困难的情况下	【困】難的情況下
科技发展规划	科技【發】展規【劃】
以后我再也不	以【後】我再也不
其实只不过是	其實【只】不過是
你已经长大了	你已經長大【了】
只是因为寂寞	【只】是因爲寂寞
我们可以看出	我們可以看【出】
精彩不容错过	精【彩】不容錯過
后果可想而知	【後】果可想而知
我回来的时候	我【回】來的時候
困难学生资助	【困】難學生資助
迈进了一大步	邁進【了】一大步
值得关注的是	值得關【注】的是
中国外汇储备	中國外【匯】儲備
可是我不后悔	可是我不【後】悔
发改委副主任	【發】改委副主任
虚拟世界里的	虛擬世界【里】的
真的是太好了	真的是太好【了】
已经到了极限	已經到【了】極限
银行承兑汇票	銀行承兌【匯】票
一切准备就绪	一切【準】備就緒
疾病控制中心	疾病控【制】中心
世界范围内的	世界【範】圍內的
并不代表他们	【並】不代【表】他們
终止劳动合同	終止勞動合【同】
公司发展战略	公司【發】展戰略
为自己找借口	爲自己找【借】口
作了明确规定	作【了】明確規定
旅游资源丰富	旅【遊】資源【豐】富
公安机关应当	公安機關應【當】
女朋友分手了	女朋友分手【了】
发挥更大作用	【發】揮更大作用
又有什么区别	又有什麼區【別】
智能手机论坛	智能手機論【壇】
一方面是由于	一方【面】是由於
一些领导干部	一些領導【幹】部
环境标志产品	環境標【志】產品
的基础上发展	的基礎上【發】展
以后再也不会	以【後】再也不會
从今以后我们	從今以【後】我們
都可以在这里	都可以在這【里】
执法人员发现	執法人員【發】現
重大技术装备	重大技【術】裝備
什么样的关系	什麼樣的關【係】
在回家的路上	在【回】家的路上
碰到这种情况	碰到這【種】情況
远程控制软件	遠程控【制】軟件
网络体系结构	網絡體【係】結構
建立了良好的	建立【了】良好的
这充分体现了	這充分體現【了】
各种不同类型	各【種】不【同】類型
创新发展模式	創新【發】展模式
本站注册用户	本站【注】冊用戶
的生活开始了	的生活開始【了】
说不出的滋味	說不【出】的滋味
摆在更加突出	【擺】在更加突【出】
积累了大量的	積纍【了】大量的
不可同日而语	不可【同】日而語
好久没有来了	好久沒有來【了】
的网络世界里	的網絡世界【里】
走出来的时候	走【出】來的時候
安全防范意识	安全防【範】意識
房地产业发展	房地產業【發】展
数据处理系统	數【據】處理【係】統
向记者展示了	【向】記者展示【了】
从某种程度上	從某【種】程度上
美国当地时间	美國【當】地時間
因为我会了解	因爲我會【了】解
谨防上当受骗	謹防上【當】受騙
房地产开发的	房地產開【發】的
那我就不去了	那我就不去【了】
一辈子的幸福	一輩子的【幸】福
喜欢上了一个	喜歡上【了】一個
全党全国人民	全【黨】全國人民
中央电视台的	中央電視【臺】的
会得到别人的	會得到【別】人的
网络办公系统	網絡辦公【係】統
以前的事情了	以前的事情【了】
带来了很大的	帶來【了】很大的
坚持立党为公	堅持立【黨】爲公
我不知道这种	我不知道這【種】
的关系越来越	的關【係】越來越
说不出的感觉	說不【出】的感覺
药物不良反应	【藥】物不良反應
在不同的地方	在不【同】的地方
记者采访时说	記者【採】訪時說
已经不一样了	已經不一樣【了】
等方面的知识	等方【面】的知識
期限劳动合同	期限勞動合【同】
他们的注意力	他們的【注】意力
特别是年轻人	特【別】是年輕人
党的作风建设	【黨】的作風建設
建设集团公司	建設集【團】公司
决策支持系统	決策支持【係】統
发展民营经济	【發】展民營經濟
公开征求意见	公開【徵】求意見
你那里有什么	你那【里】有什麼
一份报告指出	一份報告指【出】
分辨率达到了	分辨率達到【了】
上海复旦大学	上海【復】旦大學
一切都没有了	一切都沒有【了】
贫困家庭学生	貧【困】家庭學生
已经发展成为	已經【發】展成爲
克服重重困难	【克】服重重【困】難
出现这种情况	【出】現這【種】情況
在这里得到了	在這【里】得到【了】
巧克力的味道	巧【克】力的味道
挽回经济损失	【挽】【回】經濟損失
不良贷款余额	不良貸款【餘】額
已经安排好了	已經安排好【了】
卫生技术人员	衛生技【術】人員
远在千里之外	遠在【千】【里】之外
资本主义制度	資本主義【制】度
历来高度重视	【歷】來高度重視
医疗机构药品	醫療機構【藥】品
达到了预期的	達到【了】預期的
明显上升趋势	明顯上【升】趨勢
艺术类专业的	藝【術】類專業的
和平发展道路	和平【發】展道路
了一个又一个	【了】一個又一個
办法只有一个	辦法【只】有一個
给我们带来了	給我們帶來【了】
你要注意身体	你要【注】意身體
发现这是一个	【發】現這是一個
上海人才市场	上海人【才】市場
只是因为喜欢	【只】是因爲喜歡
有很大的发展	有很大的【發】展
提供了极大的	提供【了】極大的
户籍制度改革	戶籍【制】度改革
各方面的情况	各方【面】的情況
中国工艺美术	中國工藝美【術】
有这样的一种	有這樣的一【種】
第六次大面积	第六次大【面】積
不了什么作用	不【了】什麼作用
却是万万不能	卻是【萬】【萬】不能
你一定要幸福	你一定要【幸】福
在世界范围内	在世界【範】圍內
两个月过去了	兩個月過去【了】
把科学发展观	把科學【發】展觀
小提琴协奏曲	小提琴協奏【曲】
这才是真正的	這【才】是真正的
开展了一系列	開展【了】一【係】列
退出中国市场	退【出】中國市場
最后还是没有	最【後】還是沒有
比赛中的表现	比賽中的【表】現
没有任何关系	沒有任何關【係】
关系国计民生	關【係】國計民生
有关部门采取	有關部門【採】取
手机电视标准	手機電視標【準】
中国城市规划	中國城市規【劃】
回答记者提问	【回】答記者提問
市场竞争机制	市場競爭機【制】
自由亚洲电台	自由亞洲電【臺】
在不同的时间	在不【同】的時間
江苏省教育厅	江【蘇】省教育廳
与中央电视台	與中央電視【臺】
奥林匹克运动	奧林匹【克】運動
人与人的关系	人與人的關【係】
鸡蛋里挑骨头	雞蛋【里】挑骨頭
万变不离其宗	【萬】變不離其宗
猛然发现自己	猛然【發】現自己
面貌焕然一新	【面】貌煥然一新
最后一个问题	最【後】一個問題
住房制度建设	住房【制】度建設
财务管理系统	財務管理【係】統
直接后果就是	直接【後】果就是
城市规划实施	城市規【劃】實施
时间已经过了	時間已經過【了】
市场表现来看	市場【表】現來看
可是我并没有	可是我【並】沒有
进行了大量的	進行【了】大量的
党和人民赋予	【黨】和人民賦予
第一次见面就	第一次見【面】就
我已经放弃了	我已經放棄【了】
两个人的关系	兩個人的關【係】
建立了自己的	建立【了】自己的
就可以看出来	就可以看【出】來
可以为所欲为	可以爲所【欲】爲
给我就可以了	給我就可以【了】
出去玩的时候	【出】去玩的時候
过了多长时间	過【了】多長時間
以免上当受骗	以免上【當】受騙
就是这样的了	就是這樣的【了】
以后绝对不会	以【後】絕對不會
售后服务中心	售【後】服務中心
都没有发生过	都沒有【發】生過
制定了一系列	【制】定【了】一【係】列
自己是怎么了	自己是怎麼【了】
一个馒头引发	一個饅頭引【發】
同时也有利于	【同】時也有利於
联合下发通知	聯合下【發】通知
一直没有出现	一直沒有【出】現
出了什么事情	【出】【了】什麼事情
一系列的问题	一【係】列的問題
独立董事制度	獨立董事【制】度
关系群众切身	關【係】群眾切身
那时我才知道	那時我【才】知道
有不同的理解	有不【同】的理解
向人们展示了	【向】人們展示【了】
最幸福的时候	最【幸】福的時候
丰富的蛋白质	【豐】富的蛋白質
在不同的时候	在不【同】的時候
在别人的痛苦	在【別】人的痛苦
半个小时以后	半個小時以【後】
面对这个世界	【面】對這個世界
在某种意义上	在某【種】意義上
统计数据表明	統計數【據】【表】明
最了解自己的	最【了】解自己的
辽宁中医杂志	遼寧中醫雜【志】
事情都过去了	事情都過去【了】
说出了自己的	說【出】【了】自己的
实战参考价值	實戰【參】考價值
土地利用规划	土地利用規【劃】
有可能会出现	有可能會【出】現
数据库管理员	數【據】庫管理員
职业道德规范	職業道德規【範】
也是一种责任	也是一【種】責任
纪念红军长征	紀念紅軍長【徵】
开发投资公司	開【發】投資公司
不说话我走了	不說話我走【了】
吃不了兜着走	吃不【了】兜著走
知道哪里来的	知道哪【里】來的
我现在要出去	我現在要【出】去
椎间盘突出症	椎間盤突【出】【症】
以事实为依据	以事實爲依【據】
再也不会回来	再也不會【回】來
人民政府共同	人民政府共【同】
由于历史原因	由於【歷】史原因
国际会计准则	國際會計【準】則
过了一段时间	過【了】一段時間
公共卫生体系	公共衛生體【係】
我有一个同学	我有一個【同】學
呈现出明显的	呈現【出】明顯的
这是不是一种	這是不是一【種】
一下就可以了	一下就可以【了】
面向对象设计	【面】【向】對象設計
的中央电视台	的中央電視【臺】
出现在我面前	【出】現在我【面】前
已经有了自己	已經有【了】自己
离开了自己的	離開【了】自己的
引起了社会的	引起【了】社會的
生活中的各种	生活中的各【種】
你的心里没有	你的心【里】沒有
可持续发展和	可持續【發】展和
完成了自己的	完成【了】自己的
服务西部计划	服務西部計【劃】
什么样的人才	什麼樣的人【才】
最先进的技术	最先進的技【術】
医疗保障体系	醫療保障體【係】
等方面的优势	等方【面】的優勢
如何才能找到	如何【才】能找到
准备好的时候	【準】備好的時候
各方面的意见	各方【面】的意見
周杰伦周杰伦	【周】【傑】倫【周】【傑】倫
证明了这一点	證明【了】這一點
只能爱一个人	【只】能愛一個人
我该怎么面对	我該怎麼【面】對
有志者事竟成	有【志】者事竟成
了解到的情况	【了】解到的情況
到底是怎么了	到底是怎麼【了】
网上交易平台	網上交易平【臺】
优化发展环境	優化【發】展環境
这方面的能力	這方【面】的能力
万有引力定律	【萬】有引力定律
制定了详细的	【制】定【了】詳細的
我的心里一直	我的心【里】一直
开始了第一次	開始【了】第一次
的发展作出了	的【發】展作【出】【了】
社会和谐发展	社會和諧【發】展
工作中出现的	工作中【出】現的
我都不认识了	我都不認識【了】
付出了自己的	付【出】【了】自己的
我已经想好了	我已經想好【了】
等方面的原因	等方【面】的原因
到这里的时候	到這【里】的時候
尽快联系我们	【盡】快聯【係】我們
蒙古族自治县	【蒙】古族自治縣
都不了解自己	都不【了】解自己
才能从根本上	【才】能從根本上
什么都不想了	什麼都不想【了】
获得博士学位	【獲】得博士學位
不是很清楚了	不是很清楚【了】
调查数据显示	調查數【據】顯示
致命的吸引力	【致】命的吸引力
准备工作正在	【準】備工作正在
只是我不知道	【只】是我不知道
千万不要错过	【千】【萬】不要錯過
发展社会事业	【發】展社會事業
区别不同情况	區【別】不【同】情況
春秋战国时期	春【秋】戰國時期
了一个女孩子	【了】一個女孩子
汽车制造企业	汽車【制】造企業
视频监控系统	視頻監控【係】統
制造业的发展	【制】造業的【發】展
这是一种怎样	這是一【種】怎樣
的过程中发现	的過程中【發】現
和发展中国家	和【發】展中國家
同一起跑线上	【同】一起跑線上
据新华网报道	【據】新華網報道
怎么了是不是	怎麼【了】是不是
只有一个中国	【只】有一個中國
受到了很大的	受到【了】很大的
党的创新理论	【黨】的創新理論
为了不让自己	爲【了】不讓自己
出席全国政协	【出】席全國政協
媒体见面会上	媒體見【面】會上
更年期综合症	更年期綜合【症】
信息披露制度	信息披露【制】度
生命只有一次	生命【只】有一次
出国留学人员	【出】國留學人員
一个人在家里	一個人在家【里】
高等教育发展	高等教育【發】展
当时我不知道	【當】時我不知道
到底怎么样了	到底怎麼樣【了】
前的最后一个	前的最【後】一個
实现共同发展	實現共【同】【發】展
没有发现自己	沒有【發】現自己
得到了广泛的	得到【了】廣泛的
我只能告诉你	我【只】能告訴你
上调准备金率	上調【準】備金率
这方面的信息	這方【面】的信息
国家发展战略	國家【發】展戰略
网络游戏运营	網絡【遊】戲運營
本报记者采访	本報記者【採】訪
注册用户才能	【注】冊用戶【才】能
你还是选择了	你還是選擇【了】
让我感觉到了	讓我感覺到【了】
签订合作协议	【籖】訂合作協議
社会保险制度	社會保險【制】度
有所不同的是	有所不【同】的是
但是我并没有	但是我【並】沒有
还是为了自己	還是爲【了】自己
如果你的心里	如果你的心【里】
抗日战争爆发	抗日戰爭爆【發】
他现在在哪里	他現在在哪【里】
的时候想起了	的時候想起【了】
抑制通货膨胀	抑【制】通貨膨脹
前的准备工作	前的【準】備工作
发生什么事了	【發】生什麼事【了】
也没有什么了	也沒有什麼【了】
只知道自己的	【只】知道自己的
限制人身自由	限【制】人身自由
我一定会回来	我一定會【回】來
处理人际关系	處理人際關【係】
放弃了自己的	放棄【了】自己的
下一篇更精彩	下一篇更精【彩】
形成了巨大的	形成【了】巨大的
面对这个问题	【面】對這個問題
是中国历史上	是中國【歷】史上
得克萨斯州的	得【克】薩斯州的
只不过是因为	【只】不過是因爲
你知道我心里	你知道我心【里】
取得了一系列	取得【了】一【係】列
计划经济时代	計【劃】經濟時代
也是理所当然	也是理所【當】然
香格里拉饭店	香格【里】拉飯店
玩游戏的时候	玩【遊】戲的時候
志愿服务工作	【志】願服務工作
去年同期上升	去年【同】期上【升】
教育部批准的	教育部批【準】的
广大共产党员	廣大共產【黨】員
证明了自己的	證明【了】自己的
起到了一定的	起到【了】一定的
旅游电子商务	旅【遊】電子商務
保持密切联系	保持密切聯【係】
中国金融体系	中國金融體【係】
这么多人面前	這麼多人【面】前
只对你有感觉	【只】對你有感覺
生活中的困难	生活中的【困】難
引起了很大的	引起【了】很大的
改变了自己的	改變【了】自己的
来的幸福时光	來的【幸】福時光
进一步扩大了	進一步擴大【了】
发生了巨大的	【發】生【了】巨大的
且听下回分解	且聽下【回】分解
干什么去了啊	【幹】什麼去【了】啊
最了解我的人	最【了】解我的人
我一直在这里	我一直在這【里】
国民经济计划	國民經濟計【劃】
发展资本市场	【發】展資本市場
我们在这方面	我們在這方【面】
提供了坚实的	提供【了】堅實的
取得了巨大的	取得【了】巨大的
终于浮出水面	終於浮【出】水【面】
打电话给我了	打電話給我【了】
海南师范大学	海南師【範】大學
留学回国人员	留學【回】國人員
就已经注定了	就已經【注】定【了】
这个世界上了	這個世界上【了】
也就那么回事	也就那麼【回】事
以下几个问题	以下【幾】個問題
发展统计公报	【發】展統計公報
不是为了赚钱	不是爲【了】賺錢
当前经济形势	【當】前經濟形勢
宏观经济数据	宏觀經濟數【據】
党政领导班子	【黨】政領導班子
实现了自己的	實現【了】自己的
售后服务人员	售【後】服務人員
可持续性发展	可持續性【發】展
以法律为准绳	以法律爲【準】繩
网络游戏开发	網絡【遊】戲開【發】
什么事情发生	什麼事情【發】生
把他放在心里	把他放在心【里】
系列数码相机	【係】列數碼相機
科比布莱恩特	科比【佈】萊恩特
发展中国家和	【發】展中國家和
开始了他们的	開始【了】他們的
得到了很大的	得到【了】很大的
地面数字电视	地【面】數字電視
只有一个办法	【只】有一個辦法
征求社会各界	【徵】求社會各界
有一种爱可以	有一【種】愛可以
志愿服务活动	【志】願服務活動
香格里拉酒店	香格【里】拉酒店
知道怎么样了	知道怎麼樣【了】
我只不过是你	我【只】不過是你
只是一个借口	【只】是一個【借】口
想到了自己的	想到【了】自己的
过了这段时间	過【了】這段時間
我在你的心里	我在你的心【里】
国务院发布了	國務院【發】【佈】【了】
现在我才明白	現在我【才】明白
前总统克林顿	前總統【克】林頓
当然你也可以	【當】然你也可以
国际奥林匹克	國際奧林匹【克】
心里的那个人	心【里】的那個人
各种社会矛盾	各【種】社會矛盾
由此可以看出	由此可以看【出】
正是因为这种	正是因爲這【種】
也是一种解脱	也是一【種】解脫
这几天都没有	這【幾】天都沒有
的时候要注意	的時候要【注】意
黎明前的黑暗	黎明前的黑【暗】
说出这样的话	說【出】這樣的話
中国经济体制	中國經濟體【制】
内蒙古新闻网	內【蒙】古新聞網
发生枪击事件	【發】生槍擊事件
白云国际机场	白【雲】國際機場
令人回味无穷	令人【回】味無窮
规范执法行为	規【範】執法行爲
你都不知道了	你都不知道【了】
之后我才知道	之【後】我【才】知道
第一次看到了	第一次看到【了】
已经一个月了	已經一個月【了】
大家可以根据	大家可以根【據】
行政复议决定	行政【復】議決定
城市建设开发	城市建設開【發】
出版社出版的	【出】版社【出】版的
进行有针对性	進行有【針】對性
为什么会发生	爲什麼會【發】生
认为这是一种	認爲這是一【種】
限制民事行为	限【制】民事行爲
发现自己的心	【發】現自己的心
希望你能回到	希望你能【回】到
因为我的心里	因爲我的心【里】
考生填报志愿	考生填報【志】願
软件开发过程	軟件開【發】過程
有困难的时候	有【困】難的時候
其实我并没有	其實我【並】沒有
克莱斯勒公司	【克】萊斯勒公司
巾帼不让须眉	巾幗不讓【須】眉
怎么了怎么了	怎麼【了】怎麼【了】
因为他的心里	因爲他的心【里】
芝加哥论坛报	芝加哥論【壇】報
电话采访时说	電話【採】訪時說
找的怎么样了	找的怎麼樣【了】
推出了全新的	推【出】【了】全新的
几十年的时间	【幾】十年的時間
的时候才知道	的時候【才】知道
我才明白什么	我【才】明白什麼
知道这是一种	知道這是一【種】
全球华语歌曲	全球華語歌【曲】
医疗服务体系	醫療服務體【係】
自己并不喜欢	自己【並】不喜歡
中国电影集团	中國電影集【團】
国家外汇储备	國家外【匯】儲備
发展文化产业	【發】展文化產業
好的我知道了	好的我知道【了】
土地开发整理	土地開【發】整理
放射性同位素	放射性【同】位素
做出来的东西	做【出】來的東西
在这个世界里	在這個世界【里】
渠道合作伙伴	渠道合作【夥】伴
就这么说定了	就這麼說定【了】
中国戏曲学院	中國戲【曲】學院
最短的时间里	最短的時間【里】
还以为你心里	還以爲你心【里】
责任强制保险	責任強【制】保險
的成绩考上了	的成績考上【了】
我看到了自己	我看到【了】自己
手机里保存的	手機【里】保存的
我永远忘不了	我永遠忘不【了】
你那里有没有	你那【里】有沒有
只不过是为了	【只】不過是爲【了】
充分发挥作用	充分【發】揮作用
我只是想看看	我【只】是想看看
重大突发事件	重大突【發】事件
十几年的时间	十【幾】年的時間
第一集团公司	第一集【團】公司
丰田汽车公司	【豐】田汽車公司
最后一个愿望	最【後】一個願望
出现在他面前	【出】現在他【面】前
一些突出问题	一些突【出】問題
提供了很好的	提供【了】很好的
你看了就知道	你看【了】就知道
如果不是为了	如果不是爲【了】
你不是看了吗	你不是看【了】嗎
现在我知道了	現在我知道【了】
首张同名专辑	首張【同】名專輯
因为我看到了	因爲我看到【了】
就是这种感觉	就是這【種】感覺
有人在你面前	有人在你【面】前
也是一种美丽	也是一【種】美麗
只是我一个人	【只】是我一個人
海淀公安分局	海【澱】公安分局
到了这个时候	到【了】這個時候
没有后顾之忧	沒有【後】顧之憂
获得巨大成功	【獲】得巨大成功
相当于人民币	相【當】於人民幣
风力发电机组	風力【發】電機組
刚才不好意思	剛【才】不好意思
与中国共产党	與中國共產【黨】
不知道怎么了	不知道怎麼【了】
引起了巨大的	引起【了】巨大的
面对此情此景	【面】對此情此景
几个朋友一起	【幾】個朋友一起
马里亚纳群岛	馬【里】亞納群島
参加合作医疗	【參】加合作醫療
可以看出一个	可以看【出】一個
土地供应计划	土地供應計【劃】
情深深雨蒙蒙	情深深雨【蒙】【蒙】
发生了一系列	【發】生【了】一【係】列
我错了我错了	我錯【了】我錯【了】
可以根据不同	可以根【據】不【同】
表面上看起来	【表】【面】上看起來
有更大的发展	有更大的【發】展
我觉得很幸福	我覺得很【幸】福
在过去几个月	在過去【幾】個月
人们的注意力	人們的【注】意力
做了重要讲话	做【了】重要講話
发布会上获悉	【發】【佈】會上【獲】悉
忘记了自己的	忘記【了】自己的
心里默默的说	心【里】默默的說
我发现我已经	我【發】現我已經
销售价格同比	銷售價格【同】比
所以我们必须	所以我們必【須】
前的最后一次	前的最【後】一次
形成了一定的	形成【了】一定的
出席了开幕式	【出】席【了】開幕式
计算机制造商	計算機【制】造商
国家发改委的	國家【發】改委的
参加各种各样	【參】加各【種】各樣
我知道了什么	我知道【了】什麼
等方面的限制	等方【面】的限【制】
在他们的面前	在他們的【面】前
企业规章制度	企業規章【制】度
提高党的执政	提高【黨】的執政
回到这个地方	【回】到這個地方
面对这种情况	【面】對這【種】情況
网络游戏中的	網絡【遊】戲中的
不知道在哪里	不知道在哪【里】
英雄莫问出处	英雄莫問【出】處
你怎么不说了	你怎麼不說【了】
之后的第一个	之【後】的第一個
没有什么区别	沒有什麼區【別】
带来了全新的	帶來【了】全新的
想起了自己的	想起【了】自己的
在我心里已经	在我心【里】已經
给予党纪政纪	給予【黨】紀政紀
游戏的过程中	【遊】戲的過程中
了房地产市场	【了】房地產市場
香烟爱上火柴	香【煙】愛上火柴
出现在眼前的	【出】現在眼前的
造成了严重的	造成【了】嚴重的
里程碑意义的	【里】程碑意義的
发现自己错了	【發】現自己錯【了】
现在已经到了	現在已經到【了】
我发现我现在	我【發】現我現在
垃圾焚烧发电	垃圾焚燒【發】電
就是因为这种	就是因爲這【種】
只是你不知道	【只】是你不知道
软件开发工具	軟件開【發】工具
轻轻的我走了	輕輕的我走【了】
世界发达国家	世界【發】達國家
搞的怎么样了	搞的怎麼樣【了】
代表中国先进	代【表】中國先進
混合动力系统	混合動力【係】統
退出历史舞台	退【出】【歷】史舞【臺】
游戏下载中心	【遊】戲下載中心
现在是在那里	現在是在那【里】
现在已经有了	現在已經有【了】
世界巡回演唱	世界巡【回】演唱
在他们的眼里	在他們的眼【里】
台湾媒体报道	【臺】灣媒體報道
再也不会出现	再也不會【出】現
手机彩信下载	手機【彩】信下載
最后一个离开	最【後】一個離開
在我们的面前	在我們的【面】前
托特纳姆热刺	【托】特納姆熱刺
可以得到幸福	可以得到【幸】福
只是因为他们	【只】是因爲他們
体制改革方案	體【制】改革方案
公共广播系统	公共廣播【係】統
谢谢你给了我	謝謝你給【了】我
怎么现在才来	怎麼現在【才】來
滨海新区开发	濱海新區開【發】
结束了自己的	結束【了】自己的
造成了很大的	造成【了】很大的
喜欢上了这个	喜歡上【了】這個
千古风流人物	【千】古風流人物
点击下面相应	點擊下【面】相應
亲爱的同学们	親愛的【同】學們
的心情去面对	的心情去【面】對
以后的事情了	以【後】的事情【了】
某种程度上的	某【種】程度上的
有更好的发展	有更好的【發】展
让别人看到我	讓【別】人看到我
了人与人之间	【了】人與人之間
产生负面影响	產生負【面】影響
进一步的了解	進一步的【了】解
留下联系方式	留下聯【係】方式
我们已经有了	我們已經有【了】
只有一个男人	【只】有一個男人
为了达到自己	爲【了】達到自己
我也说不出来	我也說不【出】來
写出来的东西	寫【出】來的東西
的负责人表示	的負責人【表】示
发电有限公司	【發】電有限公司
系统的稳定性	【係】統的穩定性
一种生活态度	一【種】生活態度
面对各种各样	【面】對各【種】各樣
只是在我们的	【只】是在我們的
数据采集系统	數【據】【採】集【係】統
我想了解一下	我想【了】解一下
说出了这句话	說【出】【了】這句話
人体免疫系统	人體免疫【係】統
想尽一切办法	想【盡】一切辦法
成绩管理系统	成績管理【係】統
付出了巨大的	付【出】【了】巨大的
千方百计增加	【千】方百計增加
里的每一个人	【里】的每一個人
可根据自己的	可根【據】自己的
看见了自己的	看見【了】自己的
历史上最大的	【歷】史上最大的
知道你的心里	知道你的心【里】
接受采访时说	接受【採】訪時說
没有看到你了	沒有看到你【了】
我只是想知道	我【只】是想知道
参加养老保险	【參】加養老保險
我当然知道啊	我【當】然知道啊
发展到现在的	【發】展到現在的
人力资源系统	人力資源【係】統
不注意的时候	不【注】意的時候
在自己的面前	在自己的【面】前
记者采访发现	記者【採】訪【發】現
今天是怎么了	今天是怎麼【了】
什么时候出来	什麼時候【出】來
带来了更大的	帶來【了】更大的
建成后将成为	建成【後】將成爲
股权激励计划	股權激勵計【劃】
有以下几方面	有以下【幾】方【面】
以胡锦涛同志	以【胡】錦濤【同】【志】
只不过是自己	【只】不過是自己
但是他并没有	但是他【並】沒有
法律法规汇编	法律法規【匯】編
中出现了一个	中【出】現【了】一個
历史最高纪录	【歷】史最高紀錄
他已经成为了	他已經成爲【了】
这一切都只是	這一切都【只】是
一直在我心里	一直在我心【里】
通过各种方式	通過各【種】方式
出现了大量的	【出】現【了】大量的
我也不想说了	我也不想說【了】
变成了现在的	變成【了】現在的
丰富的想象力	【豐】富的想象力
岂能尽如人意	豈能【盡】如人意
某种意义上的	某【種】意義上的
自己的事情了	自己的事情【了】
氯化钠注射液	氯化鈉【注】射液
最常见的一种	最常見的一【種】
十大中文金曲	十大中文金【曲】
以后我一定会	以【後】我一定會
发现我爱上了	【發】現我愛上【了】
几乎每天都在	【幾】乎每天都在
发生什么样的	【發】生什麼樣的
也是一种幸福	也是一【種】【幸】福
执法人员当场	執法人員【當】場
我并没有什么	我【並】沒有什麼
等了半个小时	等【了】半個小時
很幸福的事情	很【幸】福的事情
可以看得出来	可以看得【出】來
获得了巨大的	【獲】得【了】巨大的
行政体制改革	行政體【制】改革
准备的情况下	【準】備的情況下
我不是说过了	我不是說過【了】
身边已经有了	身邊已經有【了】
的发展做出了	的【發】展做【出】【了】
以后我也不会	以【後】我也不會
生产技术规程	生產技【術】規程
那有什么关系	那有什麼關【係】
我发现我错了	我【發】現我錯【了】
克制不住自己	【克】【制】不住自己
上海电气集团	上海電氣集【團】
都没看到你了	都沒看到你【了】
发生安全事故	【發】生安全事故
确保万无一失	確保【萬】無一失
只是时间问题	【只】是時間問題
要根据自己的	要根【據】自己的
食品药品安全	食品【藥】品安全
发达国家水平	【發】達國家水平
经济技术指标	經濟技【術】指標
没有任何一种	沒有任何一【種】
战略合作关系	戰略合作關【係】
庆祝香港回归	慶祝香港【回】歸
当地有关部门	【當】地有關部門
了这个世界上	【了】這個世界上
为了你我愿意	爲【了】你我願意
怎么了不说话	怎麼【了】不說話
在他们的心里	在他們的心【里】
不经意间发现	不經意間【發】現
与中国的关系	與中國的關【係】
只不过是我们	【只】不過是我們
我有了自己的	我有【了】自己的
更多的人了解	更多的人【了】解
过了这么多年	過【了】這麼多年
在中国发展的	在中國【發】展的
西班牙马德里	西班牙馬德【里】
可是我的心里	可是我的心【里】
春秋战国时代	春【秋】戰國時代
那我不知道了	那我不知道【了】
出现了一定的	【出】現【了】一定的
几乎每天都要	【幾】乎每天都要
出现在我身边	【出】現在我身邊
是怎么了怎么	是怎麼【了】怎麼
提供了很大的	提供【了】很大的
得到了极大的	得到【了】極大的
不要在她面前	不要在她【面】前
说不出的味道	說不【出】的味道
做出重要贡献	做【出】重要貢獻
和平与发展的	和平與【發】展的
我也不是那种	我也不是那【種】
已经面目全非	已經【面】目全非
我们并不知道	我們【並】不知道
一些别有用心	一些【別】有用心
没有什么了不	沒有什麼【了】不
再生资源回收	再生資源【回】收
并不是最好的	【並】不是最好的
放弃了所有的	放棄【了】所有的
中等发达国家	中等【發】達國家
以后我才知道	以【後】我【才】知道
出现在舞台上	【出】現在舞【臺】上
有的只是一个	有的【只】是一個
在我身上发生	在我身上【發】生
洛阳师范学院	洛陽師【範】學院
只有你一个人	【只】有你一個人
就没有发言权	就沒有【發】言權
到哪里去了呢	到哪【里】去【了】呢
什么都不了解	什麼都不【了】解
发生在我身上	【發】生在我身上
的时候才会有	的時候【才】會有
推动两国关系	推動兩國關【係】
流行性出血热	流行性【出】血熱
就没有什么了	就沒有什麼【了】
中国当代艺术	中國【當】代藝【術】
其实我并不是	其實我【並】不是
每周质量报告	每【周】質量報告
我只是不知道	我【只】是不知道
没有办法控制	沒有辦法控【制】
这样才能真正	這樣【才】能真正
更加丰富多彩	更加【豐】富多【彩】
今天我才知道	今天我【才】知道
根本利益出发	根本利益【出】【發】
会员管理系统	會員管理【係】統
不就知道了吗	不就知道【了】嗎
在这段时间里	在這段時間【里】
电力体制改革	電力體【制】改革
以后有什么事	以【後】有什麼事
高于去年同期	高於去年【同】期
那你干什么呢	那你【幹】什麼呢
最后一次参加	最【後】一次【參】加
必须充分发挥	必【須】充分【發】揮
为了养家糊口	爲【了】養家糊口
桌面操作系统	桌【面】操作【係】統
这并不是一个	這【並】不是一個
所以我在这里	所以我在這【里】
下一步的发展	下一步的【發】展
几乎每天都有	【幾】乎每天都有
在我们的心里	在我們的心【里】
相当大的比例	相【當】大的比例
只是他不知道	【只】是他不知道
时间长了就会	時間長【了】就會
用户可以根据	用戶可以根【據】
但是我们必须	但是我們必【須】
事件时有发生	事件時有【發】生
完全不一样了	完全不一樣【了】
允许的范围内	允許的【範】圍內
出现的新问题	【出】現的新問題
做出了很大的	做【出】【了】很大的
研究开发机构	研究開【發】機構
出口信用保险	【出】口信用保險
不要忘了我们	不要忘【了】我們
感觉到了自己	感覺到【了】自己
带来了一定的	帶來【了】一定的
也会有所不同	也會有所不【同】
这并不是什么	這【並】不是什麼
强化复合地板	強化【復】合地【板】
你看到我了吗	你看到我【了】嗎
看了看自己的	看【了】看自己的
有不同的看法	有不【同】的看法
我们在同一个	我們在【同】一個
有什么不同吗	有什麼不【同】嗎
旅游局副局长	旅【遊】局副局長
没有人会了解	沒有人會【了】解
体现了这一点	體現【了】這一點
美国得克萨斯	美國得【克】薩斯
在以后的生活	在以【後】的生活
西北师范大学	西北師【範】大學
喜欢上了这种	喜歡上【了】這【種】
沈阳市铁西区	【瀋】陽市鐵西區
到底怎么回事	到底怎麼【回】事
我这是怎么了	我這是怎麼【了】
得到了很好的	得到【了】很好的
进行全面调查	進行全【面】調查
具体收费标准	具體收費標【準】
企业发展资金	企業【發】展資金
别让我一个人	【別】讓我一個人
医疗器械注册	醫療器械【注】冊
造成了巨大的	造成【了】巨大的
他的联系方式	他的聯【係】方式
挣扎着爬起来	掙【扎】著爬起來
在相当程度上	在相【當】程度上
长效机制建设	長效機【制】建設
深圳打折机票	深圳打【折】機票
征兆的情况下	【徵】兆的情況下
我和他的关系	我和他的關【係】
你还是不了解	你還是不【了】解
回到了自己的	【回】到【了】自己的
世界旅游组织	世界旅【遊】組織
负责人进行了	負責人進行【了】
一系列的措施	一【係】列的措施
有密切的关系	有密切的關【係】
我知道你心里	我知道你心【里】
成为关注焦点	成爲關【注】焦點
提供了更大的	提供【了】更大的
打电话给你了	打電話給你【了】
但这并不代表	但這【並】不代【表】
心里的最深处	心【里】的最深處
短短的时间里	短短的時間【里】
全世界范围内	全世界【範】圍內
也是一种生活	也是一【種】生活
你是怎么了啊	你是怎麼【了】啊
主要贸易伙伴	主要貿易【夥】伴
北京市旅游局	北京市旅【遊】局
对于这种情况	對於這【種】情況
查看更多精彩	查看更多精【彩】
我发现我自己	我【發】現我自己
于是就出现了	於是就【出】現【了】
更多的人关注	更多的人關【注】
造成了一定的	造成【了】一定的
面对这样一个	【面】對這樣一個
觉得这是一种	覺得這是一【種】
已经来不及了	已經來不及【了】
办公室的同事	辦公室的【同】事
的生存与发展	的生存與【發】展
的声音打断了	的聲音打斷【了】
我现在在这里	我現在在這【里】
在不同的世界	在不【同】的世界
男孩喜欢上了	男孩喜歡上【了】
国家级开发区	國家級開【發】區
面对的还是要	【面】對的還是要
发布会上表示	【發】【佈】會上【表】示
再也没有出现	再也沒有【出】現
什么样的后果	什麼樣的【後】果
贵州师范大学	貴州師【範】大學
打个电话回家	打個電話【回】家
又是为了什么	又是爲【了】什麼
感觉到了一种	感覺到【了】一【種】
慢慢的习惯了	慢慢的習慣【了】
表达了自己的	【表】達【了】自己的
美国经济数据	美國經濟數【據】
大战一触即发	大戰一觸即【發】
没有这种感觉	沒有這【種】感覺
计划经济时期	計【劃】經濟時期
逐年上升趋势	逐年上【升】趨勢
城镇体系规划	城鎮體【係】規【劃】
知道我的心里	知道我的心【里】
你在我的心里	你在我的心【里】
国务院公布的	國務院公【佈】的
保持了良好的	保持【了】良好的
别人的一句话	【別】人的一句話
只说了一句话	【只】說【了】一句話
知道是怎么了	知道是怎麼【了】
都是为了自己	都是爲【了】自己
嫌疑人被抓获	嫌疑人被抓【獲】
雪地里的星星	雪地【里】的星星
进行了第二次	進行【了】第二次
药品零售企业	【藥】品零售企業
同名小说改编	【同】名小說改編
你不喜欢我了	你不喜歡我【了】
吸引了大量的	吸引【了】大量的
杭州师范学院	杭州師【範】學院
访问控制列表	訪問控【制】列【表】
跟他说了以后	跟他說【了】以【後】
商业承兑汇票	商業承兌【匯】票
包括两个方面	包括兩個方【面】
进行问卷调查	進行問【捲】調查
新罕布什尔州	新罕【佈】什爾州
别人的世界里	【別】人的世界【里】
下面就让我们	下【面】就讓我們
很早就起来了	很早就起來【了】
以后我不会在	以【後】我不會在
出入境管理局	【出】入境管理局
表达我对你的	【表】達我對你的
同样的一句话	【同】樣的一句話
认识了现在的	認識【了】現在的
我现在在家里	我現在在家【里】
从来没有发现	從來沒有【發】現
导致的结果是	導【致】的結果是
我只是不喜欢	我【只】是不喜歡
出租汽车公司	【出】租汽車公司
不知是怎么了	不知是怎麼【了】
所面临的问题	所【面】臨的問題
一点都不了解	一點都不【了】解
我才知道什么	我【才】知道什麼
因为我忘不了	因爲我忘不【了】
土地出让合同	土地【出】讓合【同】
如果没有了你	如果沒有【了】你
汽车售后服务	汽車售【後】服務
几千年的历史	【幾】【千】年的【歷】史
民事诉讼证据	民事訴訟證【據】
小小的角落里	小小的角落【里】
的问题解决了	的問題解決【了】
负责人向记者	負責人【向】記者
最后一个镜头	最【後】一個鏡頭
以后再也不能	以【後】再也不能
只顾风雨兼程	【只】顧風雨兼程
自己就可以了	自己就可以【了】
蕴藏着丰富的	蘊藏著【豐】富的
这几天发生的	這【幾】天【發】生的
别的什么都不	【別】的什麼都不
客户服务系统	客戶服務【係】統
可以说是一种	可以說是一【種】
带来了不小的	帶來【了】不小的
我心里的位置	我心【里】的位置
全球经济发展	全球經濟【發】展
在中国历史上	在中國【歷】史上
有更多的了解	有更多的【了】解
就已经开始了	就已經開始【了】
两方面的原因	兩方【面】的原因
主要发达国家	主要【發】達國家
加强体育锻炼	加強體育鍛【煉】
只有一个女人	【只】有一個女人
当你爱一个人	【當】你愛一個人
游戏中的角色	【遊】戲中的角色
动漫游戏产业	動漫【遊】戲產業
由国家发改委	由國家【發】改委
我只能在这里	我【只】能在這【里】
发出最后通牒	【發】【出】最【後】通牒
和他在一起了	和他在一起【了】
其实这并不是	其實這【並】不是
不成熟的表现	不成熟的【表】現
回到我的世界	【回】到我的世界
我们只不过是	我們【只】不過是
什么样的困难	什麼樣的【困】難
财政体制改革	財政體【制】改革
魔兽世界论坛	魔獸世界論【壇】
和国家发改委	和國家【發】改委
也有了一定的	也有【了】一定的
造成了不小的	造成【了】不小的
才发现我已经	【才】【發】現我已經
跟你说什么了	跟你說什麼【了】
只属于我自己	【只】屬於我自己
人事管理系统	人事管理【係】統
知识产权制度	知識產權【制】度
中国当代文学	中國【當】代文學
阿里巴巴网站	阿【里】巴巴網站
对生活的一种	對生活的一【種】
相比去年同期	相比去年【同】期
也有了自己的	也有【了】自己的
中国特种部队	中國特【種】部隊
发现自己身上	【發】現自己身上
别人的男朋友	【別】人的男朋友
奥林匹克精神	奧林匹【克】精神
做了很多事情	做【了】很多事情
不过话说回来	不過話說【回】來
走上了不归路	走上【了】不歸路
这几天的心情	這【幾】天的心情
看了一篇文章	看【了】一篇文章
统计数字表明	統計數字【表】明
好久没见你了	好久沒見你【了】
你不认识我了	你不認識我【了】
注意个人卫生	【注】意個人衛生
我国外汇储备	我國外【匯】儲備
最喜欢的游戏	最喜歡的【遊】戲
把自己交给了	把自己交給【了】
我看到了一个	我看到【了】一個
了解我的朋友	【了】解我的朋友
被捕时被发现	被捕時被【發】現
受到了一定的	受到【了】一定的
没有发生什么	沒有【發】生什麼
特别是在别人	特【別】是在【別】人
一段时间之后	一段時間之【後】
我当时的心情	我【當】時的心情
有机玻璃制品	有機玻璃【制】品
消息人士指出	消息人士指【出】
黄金周期间的	黃金【周】期間的
这方面的消息	這方【面】的消息
特别是对那些	特【別】是對那些
逐渐浮出水面	逐漸浮【出】水【面】
发表声明宣布	【發】【表】聲明宣【佈】
不就可以了吗	不就可以【了】嗎
引起了不小的	引起【了】不小的
的时候才可以	的時候【才】可以
得到了什么呢	得到【了】什麼呢
而我只是一个	而我【只】是一個
让我们学会了	讓我們學會【了】
只不过这一次	【只】不過這一次
就会出现一个	就會【出】現一個
库尔德工人党	庫爾德工人【黨】
完全可以根据	完全可以根【據】
面对这些问题	【面】對這些問題
我们是怎么了	我們是怎麼【了】
我们共同努力	我們共【同】努力
了一次又一次	【了】一次又一次
发生在伊拉克	【發】生在伊拉【克】
积累了一定的	積纍【了】一定的
中文操作系统	中文操作【係】統
向世人展示了	【向】世人展示【了】
并不是我想的	【並】不是我想的
记者电话采访	記者電話【採】訪
我只想知道你	我【只】想知道你
之情溢于言表	之情溢於言【表】
面对面的交流	【面】對【面】的交流
我知道了好了	我知道【了】好【了】
这种感觉真的	這【種】感覺真的
主要有两方面	主要有兩方【面】
不是为了自己	不是爲【了】自己
与美国的关系	與美國的關【係】
我有几个朋友	我有【幾】個朋友
文化发展中心	文化【發】展中心
可以说是相当	可以說是相【當】
数学奥林匹克	數學奧林匹【克】
有着各种各样	有著各【種】各樣
通过这种方法	通過這【種】方法
只有一个信念	【只】有一個信念
上海公司注册	上海公司【注】冊
工艺美术大师	工藝美【術】大師
你知道什么了	你知道什麼【了】
同时也是一种	【同】時也是一【種】
这几天我一直	這【幾】天我一直
也有了很大的	也有【了】很大的
欧美发达国家	歐美【發】達國家
高等学历教育	高等學【歷】教育
我和几个朋友	我和【幾】個朋友
个人的世界里	個人的世界【里】
出现在你面前	【出】現在你【面】前
才会知道什么	【才】會知道什麼
网络游戏公司	網絡【遊】戲公司
我说什么了啊	我說什麼【了】啊
别人在我面前	【別】人在我【面】前
我只想让自己	我【只】想讓自己
我只能让自己	我【只】能讓自己
代表资格审查	代【表】資格審查
最后一次见到	最【後】一次見到
交通事故发生	交通事故【發】生
四面八方赶来	四【面】八方趕來
明太祖朱元璋	明太祖【朱】元璋
现在回想起来	現在【回】想起來
我只是想找个	我【只】是想找個
不同于一般的	不【同】於一般的
信息处理系统	信息處理【係】統
葡萄糖注射液	葡萄糖【注】射液
我们不难发现	我們不難【發】現
把它放在心里	把它放在心【里】
我希望你以后	我希望你以【後】
发送垃圾邮件	【發】送垃圾郵件
然后我就开始	然【後】我就開始
受到了极大的	受到【了】極大的
张三丰异界游	張三【豐】異界【遊】
国家级贫困县	國家級貧【困】縣
城乡统筹发展	城鄉統籌【發】展
具备了一定的	具備【了】一定的
千万不要以为	【千】【萬】不要以爲
觉得自己特别	覺得自己特【別】
好朋友的关系	好朋友的關【係】
别的什么原因	【別】的什麼原因
发布会在北京	【發】【佈】會在北京
越来越不好了	越來越不好【了】
同时也带来了	【同】時也帶來【了】
同时也得到了	【同】時也得到【了】
医药购销领域	醫【藥】購銷領域
相当大的差距	相【當】大的差距
违法药品广告	違法【藥】品廣告
经过一系列的	經過一【係】列的
这种生活方式	這【種】生活方式
为了你我可以	爲【了】你我可以
现在发现自己	現在【發】現自己
社会丑恶现象	社會【醜】【惡】現象
但并不是所有	但【並】不是所有
苏丹达尔富尔	【蘇】丹達爾富爾
三年后的今天	三年【後】的今天
沈阳师范大学	【瀋】陽師【範】大學
认识了很多人	認識【了】很多人
四川美术学院	四川美【術】學院
就已经达到了	就已經達到【了】
因为我认识了	因爲我認識【了】
人是一种幸福	人是一【種】【幸】福
有关部门表示	有關部門【表】示
苹果电脑公司	【蘋】果電腦公司
有关部门尽快	有關部門【盡】快
再一次证明了	再一次證明【了】
只是一个没有	【只】是一個沒有
道是怎么回事	道是怎麼【回】事
你怎么样了啊	你怎麼樣【了】啊
注册海外公司	【注】冊海外公司
过去的事情了	過去的事情【了】
放在我的心里	放在我的心【里】
高等教育学历	高等教育學【歷】
有相当数量的	有相【當】數量的
过了很长时间	過【了】很長時間
股指期货推出	股指期貨推【出】
移动计算技术	移動計算技【術】
资助政策体系	資助政策體【係】
发现自己没有	【發】現自己沒有
官方数据显示	官方數【據】顯示
获得了极大的	【獲】得【了】極大的
我送你回家吧	我送你【回】家吧
造成了极大的	造成【了】極大的
经历了很多的	經【歷】【了】很多的
我发现你现在	我【發】現你現在
在我心里永远	在我心【里】永遠
最后一次给你	最【後】一次給你
因为种种原因	因爲【種】【種】原因
慢慢的长大了	慢慢的長大【了】
和我没有关系	和我沒有關【係】
做出这样的事	做【出】這樣的事
有不同的答案	有不【同】的答案
对于网络游戏	對於網絡【遊】戲
他们在一起了	他們在一起【了】
最后一个女人	最【後】一個女人
自费出国留学	自費【出】國留學
污染防治技术	污染防治技【術】
已经做好准备	已經做好【準】備
义勇军进行曲	義勇軍進行【曲】
千万不要轻易	【千】【萬】不要輕易
为了保护自己	爲【了】保護自己
记者调查发现	記者調查【發】現
出现了这么好	【出】現【了】這麼好
进行适当调整	進行適【當】調整
通过一系列的	通過一【係】列的
重要合作伙伴	重要合作【夥】伴
但要注意的是	但要【注】意的是
最幸福的男人	最【幸】福的男人
国防部发言人	國防部【發】言人
韩国网络游戏	韓國網絡【遊】戲
第一次来这里	第一次來這【里】
每天都有不同	每天都有不【同】
得到了市场的	得到【了】市場的
沈阳药科大学	【瀋】陽【藥】科大學
网络游戏行业	網絡【遊】戲行業
一个好的回答	一個好的【回】答
我的心里真的	我的心【里】真的
科学研究表明	科學研究【表】明
已经没有用了	已經沒有用【了】
坚强的外表下	堅強的外【表】下
引起了极大的	引起【了】極大的
可以在一起了	可以在一起【了】
将会出现问题	將會【出】現問題
紫金山天文台	紫金山天文【臺】
开始胡思乱想	開始【胡】思亂想
面向对象语言	【面】【向】對象語言
以后再也没有	以【後】再也沒有
哈萨克斯坦的	哈薩【克】斯坦的
既得利益集团	既得利益集【團】
没有什么不同	沒有什麼不【同】
采用了全新的	【採】用【了】全新的
最后一个月的	最【後】一個月的
一种生活方式	一【種】生活方式
怎么不说了啊	怎麼不說【了】啊
法兰克福车展	法蘭【克】福車展
怎么还不回来	怎麼還不【回】來
你现在在那里	你現在在那【里】
发到我的邮箱	【發】到我的郵箱
的网络游戏中	的網絡【遊】戲中
每当我一个人	每【當】我一個人
发生化学反应	【發】生化學反應
经历过爱情的	經【歷】過愛情的
准备金率上调	【準】備金率上調
你不是有了吗	你不是有【了】嗎
还会发生什么	還會【發】生什麼
研究报告指出	研究報告指【出】
内蒙古大草原	內【蒙】古大草原
最后一个男人	最【後】一個男人
系列活动之一	【係】列活動之一
历史上最严重	【歷】史上最嚴重
一定会回来的	一定會【回】來的
在我们的眼里	在我們的眼【里】
因为我选择了	因爲我選擇【了】
该负责人表示	該負責人【表】示
几个人在一起	【幾】個人在一起
控制不住自己	控【制】不住自己
过了半个小时	過【了】半個小時
等方面的要求	等方【面】的要求
规划建筑面积	規【劃】建【築】【面】積
药品注册管理	【藥】品【注】冊管理
仔细的看了看	仔細的看【了】看
作为一种特殊	作爲一【種】特殊
事实并非如此	事實【並】非如此
党政机关工作	【黨】政機關工作
给了我太多的	給【了】我太多的
你有没有发现	你有沒有【發】現
没关系没关系	沒關【係】沒關【係】
当时我并没有	【當】時我【並】沒有
少数民族干部	少數民族【幹】部
江苏省委书记	江【蘇】省委書記
这里进行举报	這【里】進行舉報
浮动汇率制度	浮動【匯】率【制】度
目的是为了让	目的是爲【了】讓
旅游集散中心	旅【遊】集散中心
留在我的心里	留在我的心【里】
一般不会出现	一般不會【出】現
北京奥林匹克	北京奧林匹【克】
出污泥而不染	【出】污泥而不染
报名参加考试	報名【參】加考試
我不喜欢你了	我不喜歡你【了】
怎么不一样了	怎麼不一樣【了】
关于你的回忆	關於你的【回】憶
接受采访时称	接受【採】訪時稱
同意的情况下	【同】意的情況下
在这里我就不	在這【里】我就不
历史上最年轻	【歷】史上最年輕
你又不说话了	你又不說話【了】
他并不是一个	他【並】不是一個
到底想干什么	到底想【幹】什麼
面向全国招生	【面】【向】全國招生
部分商品出口	部分商品【出】口
促进科学发展	促進科學【發】展
不要在我面前	不要在我【面】前
更多的人参与	更多的人【參】與
土地开发面积	土地開【發】【面】積
到现在才明白	到現在【才】明白
到现在才发现	到現在【才】【發】現
毫不夸张地说	毫不【誇】張地說
在同一个地方	在【同】一個地方
人工智能技术	人工智能技【術】
这是一种悲哀	這是一【種】悲哀
应该不会出现	應該不會【出】現
你已经忘记了	你已經忘記【了】
给了我最大的	給【了】我最大的
了什么是真正	【了】什麼是真正
女孩喜欢上了	女孩喜歡上【了】
第一个站出来	第一個站【出】來
充满了美好的	充滿【了】美好的
一种不一样的	一【種】不一樣的
最不发达国家	最不【發】達國家
没什么特别的	沒什麼特【別】的
值得重点关注	值得重點關【注】
就是一种幸福	就是一【種】【幸】福
好久没有联系	好久沒有聯【係】
突然发现自己	突然【發】現自己
必须有足够的	必【須】有足夠的
短暂的时间里	短暫的時間【里】
会计报表审计	會計報【表】審計
广州白云机场	廣州白【雲】機場
真的是我错了	真的是我錯【了】
出现大起大落	【出】現大起大落
进行了充分的	進行【了】充分的
资助贫困学生	資助貧【困】學生
我坐在沙发上	我坐在沙【發】上
唱片公司签约	唱片公司【籖】約
都不会回来了	都不會【回】來【了】
在我面前出现	在我【面】前【出】現
但并不意味着	但【並】不意味著
你现在在家里	你現在在家【里】
不知如何面对	不知如何【面】對
这有什么关系	這有什麼關【係】
慢慢的过去了	慢慢的過去【了】
不认识我了吗	不認識我【了】嗎
我马上就走了	我馬上就走【了】
艺术职业学院	藝【術】職業學院
做好准备工作	做好【準】備工作
有什么区别呢	有什麼區【別】呢
随着网络游戏	隨著網絡【遊】戲
很可能会导致	很可能會導【致】
奥林匹克公园	奧林匹【克】公園
都已经成为了	都已經成爲【了】
犹豫了一会儿	猶豫【了】一會兒
造成了恶劣的	造成【了】【惡】劣的
参加体育锻炼	【參】加體育鍛【煉】
现在不一样了	現在不一樣【了】
各种生产要素	各【種】生產要素
好久不见了哦	好久不見【了】哦
引起广泛关注	引起廣泛關【注】
市场上出现了	市場上【出】現【了】
建筑节能改造	建【築】節能改造
无意中发现了	無意中【發】現【了】
我已经很幸福	我已經很【幸】福
哦我知道了啊	哦我知道【了】啊
也只能这样了	也【只】能這樣【了】
只要你告诉我	【只】要你告訴我
小小的世界里	小小的世界【里】
我现在才明白	我現在【才】明白
占主导地位的	【佔】主導地位的
屏幕上出现了	屏幕上【出】現【了】
不知道你心里	不知道你心【里】
一步步向前走	一步步【向】前走
只是一个简单	【只】是一個簡單
技术有限责任	技【術】有限責任
什么都不想干	什麼都不想【幹】
这样可以了吧	這樣可以【了】吧
发布虚假广告	【發】【佈】虛假廣告
回到那个时候	【回】到那個時候
不得不放弃了	不得不放棄【了】
完整的产业链	完整的產業【鏈】
感情的世界里	感情的世界【里】
最后一个星期	最【後】一個星期
复旦大学附属	【復】旦大學附屬
德国总理默克	德國總理默【克】
有种莫名其妙	有【種】莫名其妙
市场供求关系	市場供求關【係】
人才市场招聘	人【才】市場招聘
均可报名参加	均可報名【參】加
什么不说话了	什麼不說話【了】
一分钟有多长	一分【鍾】有多長
台湾第一美女	【臺】灣第一美女
只是一个很小	【只】是一個很小
这几天有没有	這【幾】天有沒有
产品数据管理	產品數【據】管理
我只能做一个	我【只】能做一個
然后哈哈大笑	然【後】哈哈大笑
我心里很清楚	我心【里】很清楚
软件体系结构	軟件體【係】結構
以事实为根据	以事實爲根【據】
一会儿就回来	一會兒就【回】來
我听到了一个	我聽到【了】一個
最幸福的一个	最【幸】福的一個
注意的一点是	【注】意的一點是
新闻发言人王	新聞【發】言人王
艰苦奋斗为荣	艱苦奮【鬭】爲榮
公司的基本面	公司的基本【面】
生活在同一个	生活在【同】一個
在她的脑海里	在她的腦海【里】
这个城市里的	這個城市【里】的
全球合作伙伴	全球合作【夥】伴
只是一个过客	【只】是一個過客
伊拉克战争中	伊拉【克】戰爭中
关闭系统还原	關閉【係】統還原
爱情的世界里	愛情的世界【里】
国家发展计划	國家【發】展計【劃】
几乎不可能的	【幾】乎不可能的
怎么不说了呀	怎麼不說【了】呀
企业资源规划	企業資源規【劃】
或许只是因为	或許【只】是因爲
据新华社北京	【據】新華社北京
据中央电视台	【據】中央電視【臺】
重症监护病房	重【症】監護病房
水平参差不齐	水平【參】差不齊
打断了他的话	打斷【了】他的話
我只想告诉你	我【只】想告訴你
一一去不复返	一一去不【復】返
凄凄惨惨戚戚	凄凄慘慘【戚】【戚】
遗体告别仪式	遺體告【別】儀式
难道只是为了	難道【只】是爲【了】
只有你知道的	【只】有你知道的
违反计划生育	違反計【劃】生育
遇到这种事情	遇到這【種】事情
怎么不说了呢	怎麼不說【了】呢
外汇管理体制	外【匯】管理體【制】
最后一次看到	最【後】一次看到
劳动党总书记	勞動【黨】總書記
传输控制协议	傳輸控【制】協議
充分发挥出来	充分【發】揮【出】來
你想要的幸福	你想要的【幸】福
更年期综合征	更年期綜合【徵】
黑暗的角落里	黑【暗】的角落【里】
石景山游乐园	石景山【遊】樂園
不就知道了啊	不就知道【了】啊
什么都没有了	什麼都沒有【了】
里的点点滴滴	【里】的點點滴滴
不一样的烟花	不一樣的【煙】花
新技术开发区	新技【術】開【發】區
处置突发事件	處置突【發】事件
负责人也表示	負責人也【表】示
又快又好发展	又快又好【發】展
天津一汽丰田	天津一汽【豐】田
散发着迷人的	散【發】著迷人的
周杰伦新专辑	【周】【傑】倫新專輯
以不同的方式	以不【同】的方式
这种事情发生	這【種】事情【發】生
想起了一句话	想起【了】一句話
工程技术咨询	工程技【術】咨詢
我们并不需要	我們【並】不需要
事故时有发生	事故時有【發】生
另一种形式的	另一【種】形式的
有关人士指出	有關人士指【出】
陪着我也只是	陪著我也【只】是
很幸福的样子	很【幸】福的樣子
永远不会回来	永遠不會【回】來
基金经理表示	基金經理【表】示
打折机票查询	打【折】機票查詢
历史上第一位	【歷】史上第一位
一刻我才知道	一刻我【才】知道
让他们都出现	讓他們都【出】現
人面不知何处	人【面】不知何處
怎么不认识了	怎麼不認識【了】
半个月过去了	半個月過去【了】
全世界只有你	全世界【只】有你
不仅仅是一种	不僅僅是一【種】
才可以真正的	【才】可以真正的
与中国国民党	與中國國民【黨】
发生在我身边	【發】生在我身邊
我并不是那么	我【並】不是那麼
有关专家表示	有關專家【表】示
突然出现一个	突然【出】現一個
系统体系结构	【係】統體【係】結構
回过头来看看	【回】過頭來看看
魔术师约翰逊	魔【術】師約翰遜
我只想要一个	我【只】想要一個
完全没有关系	完全沒有關【係】
联系电子邮件	聯【係】電子郵件
的愿望实现了	的願望實現【了】
松花江水污染	【鬆】花江水污染
多哈回合谈判	多哈【回】合談判
只是昙花一现	【只】是曇花一現
中国在这方面	中國在這方【面】
中国研发中心	中國研【發】中心
大型公共建筑	大型公共建【築】
不要胡思乱想	不要【胡】思亂想
并没有太大的	【並】沒有太大的
温暖的怀抱里	溫暖的懷抱【里】
阿布拉莫维奇	阿【佈】拉莫維奇
分布式数据库	分【佈】式數【據】庫
记者了解到的	記者【了】解到的
对此事进行了	對此事進行【了】
存款保险制度	存款保險【制】度
家里的顶梁柱	家【里】的頂【樑】柱
加快淘汰落后	加快淘汰落【後】
有时也是一种	有時也是一【種】
事实劳动关系	事實勞動關【係】
团中央书记处	【團】中央書記處
越来越不了解	越來越不【了】解
打电话回家了	打電話【回】家【了】
抽查结果表明	抽查結果【表】明
和你在一起了	和你在一起【了】
几乎完全一样	【幾】乎完全一樣
你都不认识了	你都不認識【了】
进入最后阶段	進入最【後】階段
不是为了什么	不是爲【了】什麼
网络游戏大作	網絡【遊】戲大作
个人出租房屋	個人【出】租房屋
并非空穴来风	【並】非空穴來風
分析人士表示	分析人士【表】示
发展的大趋势	【發】展的大趨勢
不仅仅是为了	不僅僅是爲【了】
工业用地出让	工業用地【出】讓
才可以让自己	【才】可以讓自己
实在忍不住了	實在忍不住【了】
你让我学会了	你讓我學會【了】
回答我的问题	【回】答我的問題
在路上遇到了	在路上遇到【了】
已是泪流满面	已是淚流滿【面】
我是真的错了	我是真的錯【了】
去年同期分别	去年【同】期分【別】
心里想说的话	心【里】想說的話
发布会上介绍	【發】【佈】會上介紹
祝你早日康复	祝你早日康【復】
我看到了希望	我看到【了】希望
别有一番风味	【別】有一番風味
巡回赛总决赛	巡【回】賽總決賽
发的是什么啊	【發】的是什麼啊
我发誓我爱你	我【發】誓我愛你
十几个小时的	十【幾】個小時的
带来很大困难	帶來很大【困】難
专家一致认为	專家一【致】認爲
土地管理制度	土地管理【制】度
当时我的心里	【當】時我的心【里】
才是真正意义	【才】是真正意義
绝对贫困人口	絕對貧【困】人口
代表中国政府	代【表】中國政府
并在第一时间	【並】在第一時間
在网络游戏中	在網絡【遊】戲中
我看不到你了	我看不到你【了】
三月里的小雨	三月【里】的小雨
表达了他们的	【表】達【了】他們的
只是因为自己	【只】是因爲自己
忘记了所有的	忘記【了】所有的
发展两岸关系	【發】展兩岸關【係】
深化体制改革	深化體【制】改革
动作冒险游戏	動作冒險【遊】戲
计划的一部分	計【劃】的一部分
党和国家工作	【黨】和國家工作
针对上述问题	【針】對上述問題
这只是我自己	這【只】是我自己
爱一个人只要	愛一個人【只】要
在北京签署了	在北京【籖】署【了】
我才知道原来	我【才】知道原來
得到了有效的	得到【了】有效的
我的幸福生活	我的【幸】福生活
总建筑面积为	總建【築】【面】積爲
建筑机械设备	建【築】機械設備
所以我决定了	所以我決定【了】
你想得太多了	你想得太多【了】
现在的我只能	現在的我【只】能
造成负面影响	造成負【面】影響
不是因为别的	不是因爲【別】的
尤为引人注目	尤爲引人【注】目
司法体制改革	司法體【制】改革
过几天就回去	過【幾】天就【回】去
团结互助为荣	【團】結互助爲榮
发生了很多的	【發】生【了】很多的
我怎么样才能	我怎麼樣【才】能
进行了严格的	進行【了】嚴格的
中小企业板块	中小企業【板】塊
所有网络游戏	所有網絡【遊】戲
高速下载游戏	高速下載【遊】戲
地面传输标准	地【面】傳輸標【準】
程度上反映了	程度上反映【了】
过了好长时间	過【了】好長時間
面对每一个人	【面】對每一個人
接种流感疫苗	接【種】流感疫苗
驻联合国代表	駐聯合國代【表】
最后一个电话	最【後】一個電話
只要能在一起	【只】要能在一起
精索静脉曲张	精索靜脈【曲】張
几乎无一例外	【幾】乎無一例外
映入眼帘的是	映入眼【簾】的是
这样就足够了	這樣就足夠【了】
根据相关法律	根【據】相關法律
出现了明显的	【出】現【了】明顯的
习惯了两个人	習慣【了】兩個人
向社会公布了	【向】社會公【佈】【了】
应该是很幸福	應該是很【幸】福
将于当地时间	將於【當】地時間
社会救助体系	社會救助體【係】
找到回家的路	找到【回】家的路
北京市发改委	北京市【發】改委
也许这是一种	也許這是一【種】
纳斯达克指数	納斯達【克】指數
面向对象方法	【面】【向】對象方法
我们不难看出	我們不難看【出】
新闻发布会的	新聞【發】【佈】會的
台湾东森新闻	【臺】灣東森新聞
采用了先进的	【採】用【了】先進的
我已经做好了	我已經做好【了】
我只有一句话	我【只】有一句話
再多说什么了	再多說什麼【了】
没有发表任何	沒有【發】【表】任何
和你说什么了	和你說什麼【了】
说不出的酸楚	說不【出】的酸楚
市场上出现的	市場上【出】現的
几名工作人员	【幾】名工作人員
不是一种幸福	不是一【種】【幸】福
在同一个城市	在【同】一個城市
获得硕士学位	【獲】得碩士學位
克莱斯勒集团	【克】萊斯勒集【團】
个发展中国家	個【發】展中國家
和调制解调器	和調【制】解調器
了国家发改委	【了】國家【發】改委
标准化委员会	標【準】化委員會
取得了不错的	取得【了】不錯的
断了线的风筝	斷【了】線的風箏
是啊怎么了啊	是啊怎麼【了】啊
后来的日子里	【後】來的日子【里】
东方电气集团	東方電氣集【團】
发电装机容量	【發】電裝機容量
也就无所谓了	也就無所謂【了】
你想要的回答	你想要的【回】答
特别是近年来	特【別】是近年來
没有人会注意	沒有人會【注】意
是一件幸福的	是一件【幸】福的
讲了一个故事	講【了】一個故事
这是一种幸福	這是一【種】【幸】福
网上报名系统	網上報名【係】統
成为一种负担	成爲一【種】負擔
生活在一起了	生活在一起【了】
想了一个晚上	想【了】一個晚上
旅行社了解到	旅行社【了】解到
开始了新一轮	開始【了】新一輪
吸引了众多的	吸引【了】眾多的
同济医科大学	【同】濟醫科大學
收拾东西准备	收拾東西【準】備
真让人受不了	真讓人受不【了】
海峡两岸关系	海峽兩岸關【係】
信托投资有限	信【托】投資有限
发展高峰论坛	【發】展高峰論【壇】
政治发展道路	政治【發】展道路
采用这种方法	【採】用這【種】方法
我最讨厌别人	我最討厭【別】人
好不到哪里去	好不到哪【里】去
新制度经济学	新【制】度經濟學
一千遍我爱你	一【千】遍我愛你
这时我才明白	這時我【才】明白
以后的日子里	以【後】的日子【里】
最后一个暑假	最【後】一個暑假
卫星通信系统	衛星通信【係】統
每天都要面对	每天都要【面】對
连续性出版物	連續性【出】版物
出现在你的面	【出】現在你的【面】
尼亚加拉瀑布	尼亞加拉瀑【佈】
折合人民币约	【折】合人民幣約
进行了全方位	進行【了】全方位
北大中文论坛	北大中文論【壇】
药品批发企业	【藥】品批【發】企業
强制保险条例	強【制】保險條例
我已经厌倦了	我已經厭倦【了】
肉禽及其制品	肉禽及其【制】品
一辈子的回忆	一輩子的【回】憶
发表主题演讲	【發】【表】主題演講
上市公司并购	上市公司【並】購
城市的角落里	城市的角落【里】
一年的时间里	一年的時間【里】
都看不下去了	都看不下去【了】
等方面提出了	等方【面】提【出】【了】
在这种情形下	在這【種】情形下
自己喜欢上了	自己喜歡上【了】
了之后才知道	【了】之【後】【才】知道
只知道现在的	【只】知道現在的
提供了充足的	提供【了】充足的
快速发展阶段	快速【發】展階段
今天我才明白	今天我【才】明白
发生肢体冲突	【發】生肢體【衝】突
发生的可能性	【發】生的可能性
据新华社报道	【據】新華社報道
提出行政复议	提【出】行政【復】議
后来我才明白	【後】來我【才】明白
各种突发事件	各【種】突【發】事件
在当前形势下	在【當】前形勢下
美国贸易代表	美國貿易代【表】
药品批准文号	【藥】品批【準】文號
实行交通管制	實行交通管【制】
你不是要走了	你不是要走【了】
金曲颁奖典礼	金【曲】頒獎典禮
最困难的时候	最【困】難的時候
花了很长时间	花【了】很長時間
出入境管理处	【出】入境管理處
沈阳音乐学院	【瀋】陽音樂學院
手机操作系统	手機操作【係】統
同一个世界的	【同】一個世界的
克里夫兰骑士	【克】【里】夫蘭騎士
比上年增加了	比上年增加【了】
中国民主同盟	中國民主【同】盟
处理突发事件	處理突【發】事件
明确的时间表	明確的時間【表】
医疗保障制度	醫療保障【制】度
好戏还在后头	好戲還在【後】頭
全面对外开放	全【面】對外開放
到最后还是要	到最【後】還是要
事先准备好的	事先【準】備好的
作出重大贡献	作【出】重大貢獻
只好控制自己	【只】好控【制】自己
有着异曲同工	有著異【曲】【同】工
表现可圈可点	【表】現可圈可點
双螺杆挤出机	雙螺桿擠【出】機
奥林匹克球场	奧林匹【克】球場
遇到很多困难	遇到很多【困】難
你吃饭了没有	你吃飯【了】沒有
户籍管理制度	戶籍管理【制】度
游戏中出现的	【遊】戲中【出】現的
道是为了什么	道是爲【了】什麼
不了解我自己	不【了】解我自己
短短的几句话	短短的【幾】句話
就不要再见面	就不要再見【面】
都已经过去了	都已經過去【了】
我一个人面对	我一個人【面】對
最后一个晚上	最【後】一個晚上
公安机关抓获	公安機關抓【獲】
心里真的很难	心【里】真的很難
国际贸易术语	國際貿易【術】語
作出重要贡献	作【出】重要貢獻
外汇交易中心	外【匯】交易中心
我只是个孩子	我【只】是個孩子
到最后一分钟	到最【後】一分【鍾】
选择了这条路	選擇【了】這條路
面向基层就业	【面】【向】基層就業
已经有了一个	已經有【了】一個
采取的一系列	【採】取的一【係】列
没有做好准备	沒有做好【準】備
达摩克利斯剑	達摩【克】利斯劍
永远不会后悔	永遠不會【後】悔
我突然想起了	我突然想起【了】
游戏官方网站	【遊】戲官方網站
克服种种困难	【克】服【種】【種】【困】難
文件管理系统	文件管理【係】統
当地教育部门	【當】地教育部門
共产党员保持	共產【黨】員保持
我不喜欢那种	我不喜歡那【種】
已经成为制约	已經成爲【制】約
想了很多事情	想【了】很多事情
统计指标体系	統計指標體【係】
短短的几十年	短短的【幾】十年
通过电话联系	通過電話聯【係】
前的最后一天	前的最【後】一天
公司证券发行	公司證券【發】行
程序设计技术	程序設計技【術】
奥林匹克标志	奧林匹【克】標【志】
出乎我的意料	【出】乎我的意料
土地一级开发	土地一級開【發】
农业面源污染	農業【面】源污染
食品卫生标准	食品衛生標【準】
大学校长论坛	大學校長論【壇】
经历了许多的	經【歷】【了】許多的
不能控制自己	不能控【制】自己
我爱你有几分	我愛你有【幾】分
师范大学教授	師【範】大學教授
新的一年到了	新的一年到【了】
只希望你不要	【只】希望你不要
我看了他一眼	我看【了】他一眼
桂林市委党校	桂林市委【黨】校
爽快地答应了	爽快地答應【了】
表现中规中矩	【表】現中規中矩
高级专门人才	高級專門人【才】
当一个女孩子	【當】一個女孩子
论坛点击进入	論【壇】點擊進入
遗憾也是一种	遺憾也是一【種】
人大代表提出	人大代【表】提【出】
风里来雨里去	風【里】來雨【里】去
根据相关规定	根【據】相關規定
针对中小企业	【針】對中小企業
在未来几年内	在未來【幾】年內
爱上别的女人	愛上【別】的女人
变得多姿多彩	變得多姿多【彩】
面向对象分析	【面】【向】對象分析
多种经济成分	多【種】經濟成分
订立劳动合同	訂立勞動合【同】
两岸关系和平	兩岸關【係】和平
好逸恶劳为耻	好逸【惡】勞爲恥
奥林匹克中心	奧林匹【克】中心
阿克苏诺贝尔	阿【克】【蘇】諾貝爾
公布了最新的	公【佈】【了】最新的
中共中央批准	中共中央批【準】
公司实际控制	公司實際控【制】
了中央电视台	【了】中央電視【臺】
把你放在心里	把你放在心【里】
相关准备工作	相關【準】備工作
为了不让别人	爲【了】不讓【別】人
我欲乘风归去	我【欲】乘風歸去
我现在要走了	我現在要走【了】
你心里的位置	你心【里】的位置
那是当然的了	那是【當】然的【了】
高度重视发展	高度重視【發】展
克服一切困难	【克】服一切【困】難
千叮咛万嘱咐	【千】叮嚀【萬】囑咐
有这种感觉的	有這【種】感覺的
不认识我了啊	不認識我【了】啊
为了降低成本	爲【了】降低成本
麦当劳肯德基	麥【當】勞肯德基
交通管制措施	交通管【制】措施
世界杯主题曲	世界杯主題【曲】
出乎意料的是	【出】乎意料的是
只是你的一些	【只】是你的一些
外汇管理政策	外【匯】管理政策
沉迷网络游戏	沉迷網絡【遊】戲
赛门铁克公司	賽門鐵【克】公司
当然也不例外	【當】然也不例外
机构编制管理	機構編【制】管理
肯定列表制度	肯定列【表】【制】度
输入输出设备	輸入輸【出】設備
两个人的烟火	兩個人的【煙】火
具体的时间表	具體的時間【表】
行政复议申请	行政【復】議申請
提供了巨大的	提供【了】巨大的
已经准备就绪	已經【準】備就緒
必须坚定不移	必【須】堅定不移
当务之急是要	【當】務之急是要
大致可以分为	大【致】可以分爲
你给我带来了	你給我帶來【了】
国家体彩中心	國家體【彩】中心
怎么现在才回	怎麼現在【才】【回】
由于众所周知	由於眾所【周】知
所提出的问题	所提【出】的問題
包括台湾同胞	包括【臺】灣【同】胞
新闻发布会后	新聞【發】【佈】會【後】
中国彩电企业	中國【彩】電企業
在那些日子里	在那些日子【里】
三千大千世界	三【千】大【千】世界
有太多的不舍	有太多的不【舍】
融资租赁合同	融資租賃合【同】
最突出的问题	最突【出】的問題
划时代意义的	【劃】時代意義的
我一会就走了	我一會就走【了】
不是那么回事	不是那麼【回】事
明尼苏达大学	明尼【蘇】達大學
长大后你就会	長大【後】你就會
情况时有发生	情況時有【發】生
不抽烟不喝酒	不抽【煙】不喝酒
网络文件系统	網絡文件【係】統
变得不一样了	變得不一樣【了】
一段时间以后	一段時間以【後】
由于某种原因	由於某【種】原因
特别注意的是	特【別】【注】意的是
郁闷啊郁闷啊	【鬱】悶啊【鬱】悶啊
哭了一个晚上	哭【了】一個晚上
买了很多东西	買【了】很多東西
游戏开发公司	【遊】戲開【發】公司
一种无法形容	一【種】無法形容
中国历史上的	中國【歷】史上的
中国十大杰出	中國十大【傑】【出】
迈克尔舒马赫	邁【克】爾舒馬赫
电力集团公司	電力集【團】公司
为了什么原因	爲【了】什麼原因
伊拉克问题的	伊拉【克】問題的
在那段时间里	在那段時間【里】
你是哪里的呢	你是哪【里】的呢
因为在我心里	因爲在我心【里】
药品监管部门	【藥】品監管部門
当代大学生的	【當】代大學生的
消费者提供了	消費者提供【了】
的性格决定了	的性格決定【了】
住房困难家庭	住房【困】難家庭
成为百万富翁	成爲百【萬】富翁
最后一节比赛	最【後】一節比賽
环球军事论坛	環球軍事論【壇】
几乎每天晚上	【幾】乎每天晚上
提出这个问题	提【出】這個問題
一些事情之后	一些事情之【後】
经济飞速发展	經濟飛速【發】展
千里眼顺风耳	【千】【里】眼順風耳
为什么到最后	爲什麼到最【後】
农历八月十五	農【歷】八月十五
根据调查结果	根【據】調查結果
下发紧急通知	下【發】緊急通知
风湿性心脏病	風濕性心【髒】病
绝对不会后悔	絕對不會【後】悔
受到党纪政纪	受到【黨】紀政紀
防空导弹系统	防空導彈【係】統
代表人物之一	代【表】人物之一
同学们在一起	【同】學們在一起
从另一个侧面	從另一個側【面】
出现了严重的	【出】現【了】嚴重的
心里有很多的	心【里】有很多的
已成功举办了	已成功舉辦【了】
发生食物中毒	【發】生食物中毒
现在可以了吧	現在可以【了】吧
心有余悸地说	心有【餘】悸地說
严重的抑郁症	嚴重的抑【鬱】【症】
许多发达国家	許多【發】達國家
这里有太多的	這【里】有太多的
加强这方面的	加強這方【面】的
情况比较复杂	情況比較【復】雜
科学研究发现	科學研究【發】現
几十年如一日	【幾】十年如一日
重要标志之一	重要標【志】之一
最佳旅游城市	最佳旅【遊】城市
民用建筑节能	民用建【築】節能
一种与生俱来	一【種】與生俱來
本赛季结束后	本賽季結束【後】
志愿填报指南	【志】願填報指南
有限公司共同	有限公司共【同】
建筑装潢材料	建【築】裝潢材料
苏格兰威士忌	【蘇】格蘭威士忌
从中可以看出	從中可以看【出】
才能最大限度	【才】能最大限度
最低工资制度	最低工資【制】度
真金不怕火炼	真金不怕火【煉】
但是另一方面	但是另一方【面】
四年后的今天	四年【後】的今天
学历文凭考试	學【歷】文憑考試
要三思而后行	要三思而【後】行
再过几天就要	再過【幾】天就要
只封闭式基金	【只】封閉式基金
走进我的心里	走進我的心【里】
也给我带来了	也給我帶來【了】
看的怎么样了	看的怎麼樣【了】
开心的不得了	開心的不得【了】
让别人打车去	讓【別】人打車去
另一方面也要	另一方【面】也要
高空作业平台	高空作業平【臺】
据路透社报道	【據】路透社報道
做错了一件事	做錯【了】一件事
股权激励机制	股權激勵機【制】
发生巨大变化	【發】生巨大變化
只能在电话里	【只】能在電話【里】
很久没有这种	很久沒有這【種】
最后一个对手	最【後】一個對手
最后一个知道	最【後】一個知道
大唐电信集团	大唐電信集【團】
做着同样的事	做著【同】樣的事
独家合作伙伴	獨家合作【夥】伴
羧甲基纤维素	羧甲基【纖】維素
日本丰田汽车	日本【豐】田汽車
网络游戏发展	網絡【遊】戲【發】展
黎巴嫩真主党	黎巴嫩真主【黨】
伊拉克人民的	伊拉【克】人民的
控制人口增长	控【制】人口增長
记者电话联系	記者電話聯【係】
权威人士表示	權威人士【表】示
书面劳动合同	書【面】勞動合【同】
招生计划数的	招生計【劃】數的
玉米播种面积	玉米播【種】【面】積
究竟为了什么	究竟爲【了】什麼
论坛进行交流	論【壇】進行交流
今年招生计划	今年招生計【劃】
早点回去休息	早點【回】去休息
出生的那一天	【出】生的那一天
向大家介绍了	【向】大家介紹【了】
可是我刚刚才	可是我剛剛【才】
他在接受采访	他在接受【採】訪
得到了想要的	得到【了】想要的
网络游戏下载	網絡【遊】戲下載
为发展中国家	爲【發】展中國家
医院管理系统	醫院管理【係】統
单位面积产量	單位【面】積產量
操作系统功能	操作【係】統功能
后来我才知道	【後】來我【才】知道
表示不能接受	【表】示不能接受
爱着我别说你	愛著我【別】說你
了解我的心情	【了】解我的心情
休闲网络游戏	休閑網絡【遊】戲
也是一种折磨	也是一【種】【折】磨
发现自己好象	【發】現自己好象
残疾人艺术团	殘疾人藝【術】【團】
乞力马扎罗山	乞力馬【扎】羅山
征求公众意见	【徵】求公眾意見
科学发展轨道	科學【發】展軌道
能达到的范围	能達到的【範】圍
是人类历史上	是人類【歷】史上
你的个人签名	你的個人【籖】名
那就没办法了	那就沒辦法【了】
出于人道主义	【出】於人道主義
伊拉克什叶派	伊拉【克】什葉派
怎么也来了啊	怎麼也來【了】啊
塑料制品加工	塑料【制】品加工
越来越模糊了	越來越模糊【了】
从口袋里掏出	從口袋【里】掏【出】
集散控制系统	集散控【制】【係】統
我写了一封信	我寫【了】一封信
贫困家庭子女	貧【困】家庭子女
出现在赛场上	【出】現在賽場上
我现在只希望	我現在【只】希望
真相只有一个	真相【只】有一個
低于去年同期	低於去年【同】期
看不出一个人	看不【出】一個人
获得圆满成功	【獲】得圓滿成功
不在你的心里	不在你的心【里】
感觉说不出来	感覺說不【出】來
高中毕业以后	高中畢業以【後】
中国移动集团	中國移動集【團】
迅速发展起来	迅速【發】展起來
惟一不同的是	惟一不【同】的是
为了表示感谢	爲【了】【表】示感謝
不能在一起了	不能在一起【了】
你现在干什么	你現在【幹】什麼
自动增益控制	自動增益控【制】
进行了细致的	進行【了】細【致】的
爱大了受伤了	愛大【了】受傷【了】
皇家马德里队	皇家馬德【里】隊
漫长的日子里	漫長的日子【里】
事件发生之后	事件【發】生之【後】
中国建筑学会	中國建【築】學會
真正发挥作用	真正【發】揮作用
效果并不理想	效果【並】不理想
容易相信别人	容易相信【別】人
工业自动控制	工業自動控【制】
迅速采取措施	迅速【採】取措施
该怎么去面对	該怎麼去【面】對
双方共同努力	雙方共【同】努力
标准管理人员	標【準】管理人員
再也忍不住了	再也忍不住【了】
统计过程控制	統計過程控【制】
高胆固醇血症	高膽固醇血【症】
发挥出自己的	【發】揮【出】自己的
重新启动系统	重新啓動【係】統
丰台体育中心	【豐】【臺】體育中心
哈萨克斯坦和	哈薩【克】斯坦和
发生这种情况	【發】生這【種】情況
你不是看过了	你不是看過【了】
我又怎么了啊	我又怎麼【了】啊
继续发展下去	繼續【發】展下去
失去的太多了	失去的太多【了】
中的个性签名	中的個性【籖】名
注意饮食卫生	【注】意飲食衛生
在同一个地点	在【同】一個地點
闭路电视系统	閉路電視【係】統
无论是哪一种	無論是哪一【種】
随时做好准备	隨時做好【準】備
系统配置文件	【係】統配置文件
还是要去面对	還是要去【面】對
只是我早已经	【只】是我早已經
我们几乎每天	我們【幾】乎每天
游戏门户网站	【遊】戲門戶網站
变得更加困难	變得更加【困】難
不知道就算了	不知道就算【了】
我心中的那只	我心中的那【只】
集团整体上市	集【團】整體上市
在中国的发展	在中國的【發】展
差不多就行了	差不多就行【了】
制造执行系统	【制】造執行【係】統
展开一系列的	展開一【係】列的
的历史长河中	的【歷】史長河中
当地媒体报道	【當】地媒體報道
才发现原来我	【才】【發】現原來我
数以百万计的	數以百【萬】計的
少了很多东西	少【了】很多東西
尽了最大努力	【盡】【了】最大努力
为了掩人耳目	爲【了】掩人耳目
集合资金信托	集合資金信【托】
拍卖挂牌出让	拍賣掛牌【出】讓
我该怎么办了	我該怎麼辦【了】
寒冷的日子里	寒冷的日子【里】
虚报注册资本	虛報【注】冊資本
到那里去了啊	到那【里】去【了】啊
克里斯特尔斯	【克】【里】斯特爾斯
佛罗里达大学	佛羅【里】達大學
硕士以上学历	碩士以上學【歷】
目前在伊拉克	目前在伊拉【克】
只说了一个字	【只】說【了】一個字
分手后不可以	分手【後】不可以
出租汽车行业	【出】租汽車行業
表皮生长因子	【表】皮生長因子
采用这种方式	【採】用這【種】方式
奥运会结束后	奧運會結束【後】
千钧一发之际	【千】鈞一【發】之際
历史告诉我们	【歷】史告訴我們
发布会上指出	【發】【佈】會上指【出】
付出总有回报	付【出】總有【回】報
不容易被发现	不容易被【發】現
摩托车锦标赛	摩【托】車錦標賽
获得学士学位	【獲】得學士學位
现在可以了吗	現在可以【了】嗎
取得了辉煌的	取得【了】輝煌的
只是轻描淡写	【只】是輕描淡寫
基本恢复正常	基本恢【復】正常
更多精彩新闻	更多精【彩】新聞
中国汽车出口	中國汽車【出】口
中表现出色的	中【表】現【出】色的
质量参差不齐	質量【參】差不齊
多媒体数据库	多媒體數【據】庫
国际旅游小姐	國際旅【遊】小姐
昨日发布公告	昨日【發】【佈】公告
说不出的开心	說不【出】的開心
只要你能幸福	【只】要你能【幸】福
不锈钢制品厂	不鏽鋼【制】品廠
有关方面表示	有關方【面】【表】示
党内严重警告	【黨】內嚴重警告
但并不是让你	但【並】不是讓你
只爱我一个人	【只】愛我一個人
现在才知道啊	現在【才】知道啊
永远都忘不了	永遠都忘不【了】
针对这个问题	【針】對這個問題
进一步修改后	進一步修改【後】
创意产业发展	創意產業【發】展
当前中国经济	【當】前中國經濟
费尽心机想要	費【盡】心機想要
人才激励机制	人【才】激勵機【制】
数据可以看出	數【據】可以看【出】
就觉得很幸福	就覺得很【幸】福
的造血干细胞	的造血【幹】細胞
液压升降平台	液壓【升】降平【臺】
关注官方网站	關【注】官方網站
去年同期水平	去年【同】期水平
委员会发言人	委員會【發】言人
台湾同胞投资	【臺】灣【同】胞投資
只能用一个字	【只】能用一個字
通信行业标准	通信行業標【準】
填报高考志愿	填報高考【志】願
维生素缺乏症	維生素缺乏【症】
别提有多高兴	【別】提有多高興
为了我的梦想	爲【了】我的夢想
白细胞减少症	白細胞減少【症】
在国家发改委	在國家【發】改委
一种什么样的	一【種】什麼樣的
在一个城市里	在一個城市【里】
移动彩铃下载	移動【彩】鈴下載
认识了很多的	認識【了】很多的
只有一步之遥	【只】有一步之遙
空中交通管制	空中交通管【制】
推出股指期货	推【出】股指期貨
风险管理体系	風險管理體【係】
手机游戏市场	手機【遊】戲市場
过得怎么样了	過得怎麼樣【了】
不得不面对的	不得不【面】對的
输入输出接口	輸入輸【出】接口
活着为了什么	活著爲【了】什麼
我都看到你了	我都看到你【了】
现在的我只有	現在的我【只】有
根本出路在于	根本【出】路在於
该如何去面对	該如何去【面】對
在那个世界里	在那個世界【里】
只能放在心里	【只】能放在心【里】
不按牌理出牌	不按牌理【出】牌
三年行动计划	三年行動計【劃】
外面的世界真	外【面】的世界真
参与股指期货	【參】與股指期貨
出现一些问题	【出】現一些問題
相处的日子里	相處的日子【里】
只希望你给我	【只】希望你給我
本科招生计划	本科招生計【劃】
开幕式上致辞	開幕式上【致】辭
就没有意思了	就沒有意思【了】
台湾同胞在内	【臺】灣【同】胞在內
打黑除恶专项	打黑除【惡】專項
两年多时间里	兩年多時間【里】
艺术专科学校	藝【術】專科學校
一时接受不了	一時接受不【了】
记者采访时称	記者【採】訪時稱
出乎意料之外	【出】乎意料之外
西昌卫星发射	西昌衛星【發】射
投资者提供了	投資者提供【了】
问题出在哪里	問題【出】在哪【里】
面对突如其来	【面】對突如其來
不知道从哪里	不知道從哪【里】
进一步巩固了	進一步鞏固【了】
住房建筑面积	住房建【築】【面】積
伊拉克战争是	伊拉【克】戰爭是
善后处理工作	善【後】處理工作
水轮发电机组	水輪【發】電機組
文化艺术交流	文化藝【術】交流
我来了好久了	我來【了】好久【了】
盘古开天辟地	盤古開天【闢】地
雅典奥运会后	雅典奧運會【後】
同时也意味着	【同】時也意味著
就这么开始了	就這麼開始【了】
喜欢上了女孩	喜歡上【了】女孩
袭击事件发生	襲擊事件【發】生
做得怎么样了	做得怎麼樣【了】
复合包装材料	【復】合包裝材料
汽车频道精彩	汽車頻道精【彩】
不同之处在于	不【同】之處在於
注入上市公司	【注】入上市公司
有些出人意料	有些【出】人意料
猪肉价格出现	豬肉價格【出】現
中国队获得了	中國隊【獲】得【了】
发生爆炸事故	【發】生爆炸事故
新长征突击手	新長【徵】突擊手
有一个共同点	有一個共【同】點
以后有机会的	以【後】有機會的
两岸关系发展	兩岸關【係】【發】展
证人出庭作证	證人【出】庭作證
因为我想起了	因爲我想起【了】
设立研发中心	設立研【發】中心
喜欢上了别人	喜歡上【了】【別】人
表示强烈不满	【表】示強烈不滿
程度上决定了	程度上決定【了】
经营预算制度	經營預算【制】度
好久没有这种	好久沒有這【種】
践行三个代表	踐行三個代【表】
当地民政部门	【當】地民政部門
最新研究发现	最新研究【發】現
共青团员意识	共青【團】員意識
出租车驾驶员	【出】租車駕駛員
只是冰山一角	【只】是冰山一角
明尼苏达森林	明尼【蘇】達森林
短信群发软件	短信群【發】軟件
会有什么后果	會有什麼【後】果
一旦出现问题	一旦【出】現問題
国内网络游戏	國內網絡【遊】戲
没有尽头的路	沒有【盡】頭的路
求你了求你了	求你【了】求你【了】
采取保护措施	【採】取保護措施
的比例分别为	的比例分【別】爲
的和平与发展	的和平與【發】展
国际标准组织	國際標【準】組織
进行一系列的	進行一【係】列的
纳斯达克综合	納斯達【克】綜合
世界里没有谁	世界【里】沒有誰
已经成为当前	已經成爲【當】前
和中央电视台	和中央電視【臺】
他心里有一些	他心【里】有一些
最后一次进攻	最【後】一次進攻
受到广泛关注	受到廣泛關【注】
这又何尝不是	這又何【嘗】不是
远远满足不了	遠遠滿足不【了】
有很多的不舍	有很多的不【舍】
一项调查表明	一項調查【表】明
环氧树脂地板	環氧樹脂地【板】
粉末冶金制品	粉末冶金【制】品
历史上最伟大	【歷】史上最偉大
你又怎么了啊	你又怎麼【了】啊
还含有丰富的	還含有【豐】富的
当我心情不好	【當】我心情不好
无论走到哪里	無論走到哪【里】
我对你失望了	我對你失望【了】
不到万不得已	不到【萬】不得已
明人不做暗事	明人不做【暗】事
以后就不要让	以【後】就不要讓
花开堪折直须	花開堪【折】直【須】
网络的世界里	網絡的世界【里】
做出一审判决	做【出】一審判決
规范收入分配	規【範】收入分配
安全技术规程	安全技【術】規程
由于时间关系	由於時間關【係】
不知为了什么	不知爲【了】什麼
世界了解中国	世界【了】解中國
参加社会活动	【參】加社會活動
中国国家标准	中國國家標【準】
早报记者采访	早報記者【採】訪
什么都没发生	什麼都沒【發】生
只是杯水车薪	【只】是杯水車薪
资金信托计划	資金信【托】計【劃】
别有一番滋味	【別】有一番滋味
同业拆借市场	【同】業拆【借】市場
行政强制执行	行政強【制】執行
就有机会获得	就有機會【獲】得
就给我发短信	就給我【發】短信
江苏省物价局	江【蘇】省物價局
统计资料表明	統計資料【表】明
把我放在心里	把我放在心【里】
两国关系发展	兩國關【係】【發】展
有着密切关系	有著密切關【係】
软件开发平台	軟件開【發】平【臺】
醉里挑灯看剑	醉【里】挑燈看劍
呼吁国际社会	呼【籲】國際社會
游戏点卡销售	【遊】戲點卡銷售
台湾师范大学	【臺】灣師【範】大學
发行量最大的	【發】行量最大的
因为我只有在	因爲我【只】有在
工业发展组织	工業【發】展組織
我感到很幸福	我感到很【幸】福
出生的人来说	【出】生的人來說
的生活带来了	的生活帶來【了】
奥林匹克教育	奧林匹【克】教育
比较有代表性	比較有代【表】性
部门取得联系	部門取得聯【係】
办公室了解到	辦公室【了】解到
记者联系到了	記者聯【係】到【了】
然后小心翼翼	然【後】小心翼翼
得到了大家的	得到【了】大家的
你那里是不是	你那【里】是不是
复方氨酚烷胺	【復】方氨酚烷胺
正在进行当中	正在進行【當】中
悄悄的离开了	悄悄的離開【了】
关于这方面的	關於這方【面】的
无法相提并论	無法相提【並】論
不规范的问题	不規【範】的問題
阿里山的姑娘	阿【里】山的姑【娘】
同时也增加了	【同】時也增加【了】
特种部队士兵	特【種】部隊士兵
两岸经贸论坛	兩岸經貿論【壇】
遇到什么困难	遇到什麼【困】難
建立外交关系	建立外交關【係】
原创网络游戏	原創網絡【遊】戲
想用这种方式	想用這【種】方式
向中国证监会	【向】中國證監會
说不出的想念	說不【出】的想念
终于水落石出	終於水落石【出】
第一时间联系	第一時間聯【係】
为他们提供了	爲他們提供【了】
及其派出机构	及其派【出】機構
有色金属板块	有色金屬【板】塊
姓名准考证号	姓名【準】考證號
获得世界冠军	【獲】得世界冠軍
操作控制系统	操作控【制】【係】統
我还能干什么	我還能【幹】什麼
提出了很高的	提【出】【了】很高的
合同能源管理	合【同】能源管理
国家计划经济	國家計【劃】經濟
多发性骨髓瘤	多【發】性骨髓瘤
一段时间才能	一段時間【才】能
发动机的动力	【發】動機的動力
以后的某一天	以【後】的某一天
布加勒斯特星	【佈】加勒斯特星
又有谁能了解	又有誰能【了】解
举行了盛大的	舉行【了】盛大的
彻底的失望了	徹底的失望【了】
企业年金计划	企業年金計【劃】
有种说不出的	有【種】說不【出】的
我是不是疯了	我是不是瘋【了】
标准化研究所	標【準】化研究所
国民党副主席	國民【黨】副主席
或许也是一种	或許也是一【種】
新形势下发展	新形勢下【發】展
是怎么回事呀	是怎麼【回】事呀
这种情况发生	這【種】情況【發】生
在比赛中出现	在比賽中【出】現
散发出迷人的	散【發】【出】迷人的
我实在受不了	我實在受不【了】
非全日制用工	非全日【制】用工
方面良好风气	方【面】良好風氣
要注意身体啊	要【注】意身體啊
发生瓦斯爆炸	【發】生瓦斯爆炸
我只要你快乐	我【只】要你快樂
已经不复存在	已經不【復】存在
掏出随身携带	掏【出】隨身攜帶
我的小小新娘	我的小小新【娘】
整日以泪洗面	整日以淚洗【面】
你是哪里人啊	你是哪【里】人啊
淘汰落后产能	淘汰落【後】產能
云南省公安厅	【雲】南省公安廳
将注意力集中	將【注】意力集中
国际马拉松赛	國際馬拉【鬆】賽
最近怎么样了	最近怎麼樣【了】
国产网络游戏	國產網絡【遊】戲
在很长时间里	在很長時間【里】
做出明确规定	做【出】明確規定
未来发展前景	未來【發】展前景
大声的哭出来	大聲的哭【出】來
首先映入眼帘	首先映入眼【簾】
怎么会在这里	怎麼會在這【里】
粉红色的回忆	粉紅色的【回】憶
想了很长时间	想【了】很長時間
忍不住回头望	忍不住【回】頭望
一系列的活动	一【係】列的活動
怎么样才可以	怎麼樣【才】可以
骗取出口退税	騙取【出】口退稅
证券发行管理	證券【發】行管理
问卷调查显示	問【捲】調查顯示
江苏省公安厅	江【蘇】省公安廳
代表中共中央	代【表】中共中央
一天的过去了	一天的過去【了】
只能告诉自己	【只】能告訴自己
高考成绩公布	高考成績公【佈】
历经千辛万苦	【歷】經【千】辛【萬】苦
再也承受不了	再也承受不【了】
并签署正式的	【並】【籖】署正式的
奖学金获得者	獎學金【獲】得者
的爱并不一定	的愛【並】不一定
网络游戏来说	網絡【遊】戲來說
我已经做到了	我已經做到【了】
心里有太多的	心【里】有太多的
学籍电子注册	學籍電子【注】冊
发现美的眼睛	【發】現美的眼睛
被发现的事物	被【發】現的事物
长安汽车集团	長安汽車集【團】
当地公安部门	【當】地公安部門
机会只有一次	機會【只】有一次
天然气欧佩克	天然氣歐佩【克】
和他怎么样了	和他怎麼樣【了】
控制不了自己	控【制】不【了】自己
长期稳定发展	長期穩定【發】展
电子监控系统	電子監控【係】統
在未来的发展	在未來的【發】展
限制性内切酶	限【制】性內切酶
在我面前提起	在我【面】前提起
我等你很久了	我等你很久【了】
成了名副其实	成【了】名副其實
顺利地完成了	順利地完成【了】
的东西太多了	的東西太多【了】
真空冷冻干燥	真空冷凍【幹】燥
香港回归祖国	香港【回】歸祖國
下了一天的雨	下【了】一天的雨
党政领导机关	【黨】政領導機關
存在因果关系	存在因果關【係】
陷入万劫不复	陷入【萬】劫不【復】
发生道路交通	【發】生道路交通
每当我在夜里	每【當】我在夜【里】
偷偷的控制着	偷偷的控【制】著
增强共青团员	增強共青【團】員
感觉到了什么	感覺到【了】什麼
从另一个方面	從另一個方【面】
到底在哪里呢	到底在哪【里】呢
香榭丽舍大街	香榭麗【舍】大街
其实这是一种	其實這是一【種】
伊斯坦布尔的	伊斯坦【佈】爾的
针对中国市场	【針】對中國市場
当她不再爱你	【當】她不再愛你
刷新历史纪录	刷新【歷】史紀錄
目的都是为了	目的都是爲【了】
要在分手以后	要在分手以【後】
什么也不是了	什麼也不是【了】
可能在一起了	可能在一起【了】
里杰卡尔德的	【里】【傑】卡爾德的
不跟你说话了	不跟你說話【了】
正在发生变化	正在【發】生變化
占用基本农田	【佔】用基本農田
出现异常波动	【出】現異常波動
心理危机干预	心理危機【幹】預
胡锦涛在北京	【胡】錦濤在北京
深圳公司注册	深圳公司【注】冊
中国医药市场	中國醫【藥】市場
执法人员当即	執法人員【當】即
在内的一系列	在內的一【係】列
建议重点关注	建議重點關【注】
玩家可以根据	玩家可以根【據】
一个不折不扣	一個不【折】不扣
带来了严重的	帶來【了】嚴重的
为了能更好的	爲【了】能更好的
我发现了一个	我【發】現【了】一個
怎样才能做到	怎樣【才】能做到
得到了一定的	得到【了】一定的
证实了这一点	證實【了】這一點
伊拉克战争的	伊拉【克】戰爭的
案件时有发生	案件時有【發】生
留了电话号码	留【了】電話號碼
表现差强人意	【表】現差強人意
所有参赛选手	所有【參】賽選手
行政诉讼证据	行政訴訟證【據】
爱一回伤一回	愛一【回】傷一【回】
在那里干什么	在那【里】【幹】什麼
比以前好多了	比以前好多【了】
我该怎么回答	我該怎麼【回】答
在游戏世界中	在【遊】戲世界中
吉林艺术学院	吉林藝【術】學院
提高准备金率	提高【準】備金率
比赛的转折点	比賽的轉【折】點
我明白了许多	我明白【了】許多
在我心里留下	在我心【里】留下
运动员参加了	運動員【參】加【了】
没有利害关系	沒有利害關【係】
好不容易找了	好不容易找【了】
为了公共利益	爲【了】公共利益
双方首发阵容	雙方首【發】陣容
一旦发生事故	一旦【發】生事故
就共同关心的	就共【同】關心的
中层领导干部	中層領導【幹】部
正版操作系统	正版操作【係】統
香港汇丰银行	香港【匯】【豐】銀行
作业成本控制	作業成本控【制】
一去不复返的	一去不【復】返的
占据一席之地	【佔】【據】一席之地
促进两国关系	促進兩國關【係】
占全国总人口	【佔】全國總人口
世界杯历史上	世界杯【歷】史上
春夏秋冬四季	春夏【秋】【冬】四季
联合国代表团	聯合國代【表】【團】
一生只有一次	一生【只】有一次
得克萨斯大学	得【克】薩斯大學
假冒注册商标	假冒【注】冊商標
做好充分准备	做好充分【準】備
动画制作公司	動畫【制】作公司
化干戈为玉帛	化【幹】戈爲玉帛
在别人的立场	在【別】人的立場
提供了更好的	提供【了】更好的
后来她告诉我	【後】來她告訴我
采用了最新的	【採】用【了】最新的
去年同期回落	去年【同】期【回】落
大众汽车集团	大眾汽車集【團】
财务报告准则	財務報告【準】則
未来的日子里	未來的日子【里】
财产申报制度	財產申報【制】度
抗精神病药物	抗精神病【藥】物
当地工商部门	【當】地工商部門
家里经济条件	家【里】經濟條件
只要是你送的	【只】要是你送的
指挥控制系统	指揮控【制】【係】統
推出的新专辑	推【出】的新專輯
基准利率上调	基【準】利率上調
发展体育运动	【發】展體育運動
渐渐浮出水面	漸漸浮【出】水【面】
做到了这一点	做到【了】這一點
海水不可斗量	海水不可【鬭】量
派出所副所长	派【出】所副所長
我心里好难受	我心【里】好難受
的标准来衡量	的標【準】來衡量
千万不要相信	【千】【萬】不要相信
同时也是为了	【同】時也是爲【了】
年伊拉克战争	年伊拉【克】戰爭
我现在在游戏	我現在在【遊】戲
中国化工集团	中國化工集【團】
坚强的意志力	堅強的意【志】力
美容美发学校	美容美【發】學校
伊拉克人死亡	伊拉【克】人死亡
农历七月初七	農【歷】七月初七
翻到最后一页	翻到最【後】一頁
只是朋友关系	【只】是朋友關【係】
只有死路一条	【只】有死路一條
对不起我错了	對不起我錯【了】
什么时候发的	什麼時候【發】的
发生了性关系	【發】生【了】性關【係】
做好了充分的	做好【了】充分的
一个与众不同	一個與眾不【同】
发展中日关系	【發】展中日關【係】
研究人员表示	研究人員【表】示
呈现上升趋势	呈現上【升】趨勢
发生的一系列	【發】生的一【係】列
沈阳机床集团	【瀋】陽機床集【團】
存在侥幸心理	存在僥【幸】心理
多方面的因素	多方【面】的因素
产品详细参数	產品詳細【參】數
战斗机飞行员	戰【鬭】機飛行員
历尽千辛万苦	【歷】【盡】【千】辛【萬】苦
可以尝试一下	可以【嘗】試一下
已经有了一定	已經有【了】一定
建筑工程监理	建【築】工程監理
世界粮食计划	世界糧食計【劃】
技术发展水平	技【術】【發】展水平
网络游戏外挂	網絡【遊】戲外掛
五里河体育场	五【里】河體育場
我的幸福就是	我的【幸】福就是
只要相信自己	【只】要相信自己
券商借壳上市	券商【借】殼上市
开放系统互连	開放【係】統互連
联系在一起了	聯【係】在一起【了】
还没有回来吗	還沒有【回】來嗎
飞机制造公司	飛機【制】造公司
你干什么的啊	你【幹】什麼的啊
共抽查了北京	共抽查【了】北京
骗不了我自己	騙不【了】我自己
只好硬着头皮	【只】好硬著頭皮
一直以为只要	一直以爲【只】要
这么长时间了	這麼長時間【了】
在人类历史上	在人類【歷】史上
激光制导炸弹	激光【制】導炸彈
那只是一场梦	那【只】是一場夢
据国土资源部	【據】國土資源部
别让我的爱情	【別】讓我的愛情
一生只有一个	一生【只】有一個
能陪你到这里	能陪你到這【里】
证据确实充分	證【據】確實充分
万里行促进会	【萬】【里】行促進會
民事法律关系	民事法律關【係】
后悔一辈子的	【後】悔一輩子的
可是在我心里	可是在我心【里】
召回管理规定	召【回】管理規定
大会堂会见了	大會堂會見【了】
没有必然联系	沒有必然聯【係】
航天飞机发射	航天飛機【發】射
非常引人注目	非常引人【注】目
亚历山大大帝	亞【歷】山大大帝
存款基准利率	存款基【準】利率
游行示威活动	【遊】行示威活動
金属卤化物灯	金屬【滷】化物燈
获得诺贝尔奖	【獲】得諾貝爾獎
终于忍不住了	終於忍不住【了】
数字电视标准	數字電視標【準】
收到了一封信	收到【了】一封信
参加自学考试	【參】加自學考試
你给我发短信	你給我【發】短信
该怎么办才好	該怎麼辦【才】好
在哈萨克斯坦	在哈薩【克】斯坦
已经不存在了	已經不存在【了】
在这场比赛里	在這場比賽【里】
在这个平台上	在這個平【臺】上
商业同业公会	商業【同】業公會
许多事情之后	許多事情之【後】
慢慢的消失了	慢慢的消失【了】
发生了严重的	【發】生【了】嚴重的
君子和而不同	君子和而不【同】
最幸福的事情	最【幸】福的事情
当然最重要的	【當】然最重要的
党政机关干部	【黨】政機關【幹】部
一片欣欣向荣	一片欣欣【向】榮
我终于学会了	我終於學會【了】
错过了就没有	錯過【了】就沒有
外汇储备增加	外【匯】儲備增加
程度上限制了	程度上限【制】【了】
全面风险管理	全【面】風險管理
一夜之间成了	一夜之間成【了】
与众不同之处	與眾不【同】之處
现实的社会里	現實的社會【里】
由此不难看出	由此不難看【出】
同业拆借利率	【同】業拆【借】利率
因为我找到了	因爲我找到【了】
求大同存小异	求大【同】存小異
忘了你忘了我	忘【了】你忘【了】我
中国石油集团	中國石油集【團】
骄傲使人落后	驕傲使人落【後】
就是这样一种	就是這樣一【種】
多种营养成分	多【種】營養成分
布鲁塞尔举行	【佈】魯塞爾舉行
盗版音像制品	盜版音像【制】品
忘不了第一次	忘不【了】第一次
参加成人高考	【參】加成人高考
外汇市场美元	外【匯】市場美元
风险控制能力	風險控【制】能力
成绩一落千丈	成績一落【千】丈
没有别的办法	沒有【別】的辦法
抢占市场份额	搶【佔】市場份額
踩到火山喷发	踩到火山噴【發】
新闻发言人毛	新聞【發】言人毛
软件开发方法	軟件開【發】方法
有密切关系的	有密切關【係】的
效果大打折扣	效果大打【折】扣
非甾体抗炎药	非甾體抗炎【藥】
有什么不同呢	有什麼不【同】呢
酒泉卫星发射	酒泉衛星【發】射
过几天就好了	過【幾】天就好【了】
采取网上报名	【採】取網上報名
泄了气的皮球	泄【了】氣的皮球
哪里出了问题	哪【里】【出】【了】問題
中国移动彩信	中國移動【彩】信
高考填报志愿	高考填報【志】願
征收出口关税	【徵】收【出】口關稅
平平淡淡才是	平平淡淡【才】是
有一种爱只能	有一【種】愛【只】能
网络游戏作品	網絡【遊】戲作品
的希望寄托在	的希望寄【托】在
天外云卷云舒	天外【雲】【捲】【雲】舒
随时可能发生	隨時可能【發】生
驻中国代表处	駐中國代【表】處
造成这种情况	造成這【種】情況
疾病的发病率	疾病的【發】病率
回想起过去的	【回】想起過去的
售后服务方面	售【後】服務方【面】
放弃也是一种	放棄也是一【種】
我的心里永远	我的心【里】永遠
出现什么样的	【出】現什麼樣的
千万不要因为	【千】【萬】不要因爲
他向记者表示	他【向】記者【表】示
公安机关根据	公安機關根【據】
全面战略伙伴	全【面】戰略【夥】伴
第一次有这种	第一次有這【種】
是个不折不扣	是個不【折】不扣
相当大的比重	相【當】大的比重
自主神经系统	自主神經【係】統
总有一种感觉	總有一【種】感覺
经常项目外汇	經常項目外【匯】
批发价格指数	批【發】價格指數
仍然心有余悸	仍然心有【餘】悸
非洲开发银行	非洲開【發】銀行
通过调查发现	通過調查【發】現
外汇储备增长	外【匯】儲備增長
通过技术手段	通過技【術】手段
历史上有名的	【歷】史上有名的
胡锦涛主席的	【胡】錦濤主席的
没有时间限制	沒有時間限【制】
最美丽的回忆	最美麗的【回】憶
八小时工作制	八小時工作【制】
平常心去面对	平常心去【面】對
要怎么说才好	要怎麼說【才】好
将尽最大努力	將【盡】最大努力
离开我吧以后	離開我吧以【後】
奥林匹克知识	奧林匹【克】知識
出口到美国的	【出】口到美國的
人们茶余饭后	人們茶【餘】飯【後】
为了满足广大	爲【了】滿足廣大
最美好的回忆	最美好的【回】憶
报业集团授权	報業集【團】授權
原来你在这里	原來你在這【里】
以后怎么办啊	以【後】怎麼辦啊
增进相互了解	增進相互【了】解
民主党派中央	民主【黨】派中央
及其制品价格	及其【制】品價格
柏林奥林匹克	柏林奧林匹【克】
新华网内蒙古	新華網內【蒙】古
阿里巴巴收购	阿【里】巴巴收購
据上海证券报	【據】上海證券報
像一只受伤的	像一【只】受傷的
有太多的不同	有太多的不【同】
最为引人注目	最爲引人【注】目
网页模板下载	網頁模【板】下載
咸阳国际机场	【咸】陽國際機場
住房使用面积	住房使用【面】積
要有心理准备	要有心理【準】備
最后一个生日	最【後】一個生日
刚出来的时候	剛【出】來的時候
印尼苏门答腊	印尼【蘇】門答臘
令人刮目相看	令人【刮】目相看
在漫长的历史	在漫長的【歷】史
我现在没钱了	我現在沒錢【了】
大型网络游戏	大型網絡【遊】戲
国内邮发代号	國內郵【發】代號
首都布鲁塞尔	首都【佈】魯塞爾
并没有想象中	【並】沒有想象中
我就要离开了	我就要離開【了】
让你们担心了	讓你們擔心【了】
在伊拉克战争	在伊拉【克】戰爭
朽木不可雕也	朽木不可【雕】也
法兰克福汇报	法蘭【克】福【匯】報
月的最后一天	月的最【後】一天
网上填报志愿	網上填報【志】願
出现一定程度	【出】現一定程度
这里还有一个	這【里】還有一個
系统管理文件	【係】統管理文件
我们都要幸福	我們都要【幸】福
真是气死我了	真是氣死我【了】
在黄金周期间	在黃金【周】期間
规范化服务型	規【範】化服務型
的庐山真面目	的廬山真【面】目
共青团真理报	共青【團】真理報
黑恶势力犯罪	黑【惡】勢力犯罪
要自己去面对	要自己去【面】對
喜欢上了男孩	喜歡上【了】男孩
事情怎么样了	事情怎麼樣【了】
柔性制造系统	柔性【制】造【係】統
土地出让收入	土地【出】讓收入
过了好一会儿	過【了】好一會兒
中国汽车技术	中國汽車技【術】
并非一帆风顺	【並】非一帆風順
中国空间技术	中國空間技【術】
不是不想发火	不是不想【發】火
北京市药监局	北京市【藥】監局
只有他一个人	【只】有他一個人
电影分级制度	電影分級【制】度
打电话发短信	打電話【發】短信
只能寄希望于	【只】能寄希望於
在过去一年里	在過去一年【里】
受到了严重的	受到【了】嚴重的
面临的问题是	【面】臨的問題是
以同样的方式	以【同】樣的方式
烛光里的妈妈	燭光【里】的媽媽
匀速圆周运动	勻速圓【周】運動
国家外汇投资	國家外【匯】投資
沈阳市公安局	【瀋】陽市公安局
安全操作系统	安全操作【係】統
我有事要出去	我有事要【出】去
中共中央台湾	中共中央【臺】灣
可谓一波三折	可謂一波三【折】
拒绝发表评论	拒絕【發】【表】評論
大家面面相觑	大家【面】【面】相覷
恢复了往日的	恢【復】【了】往日的
所发生的事情	所【發】生的事情
还是相当不错	還是相【當】不錯
中国台湾地区	中國【臺】灣地區
坚强的去面对	堅強的去【面】對
脉冲宽度调制	脈【衝】寬度調【制】
很久没见你了	很久沒見你【了】
因为各种原因	因爲各【種】原因
游戏外挂下载	【遊】戲外掛下載
纵有千言万语	縱有【千】言【萬】語
天底下最幸福	天底下最【幸】福
没有发现什么	沒有【發】現什麼
改革开放之后	改革開放之【後】
研究人员指出	研究人員指【出】
数字控制技术	數字控【制】技【術】
逐渐恢复正常	逐漸恢【復】正常
愿意为你付出	願意爲你付【出】
另外一个方面	另外一個方【面】
想你了想你了	想你【了】想你【了】
相关数据显示	相關數【據】顯示
事件再次发生	事件再次【發】生
体坛风云人物	體【壇】風【雲】人物
做错了什么啊	做錯【了】什麼啊
是要付出代价	是要付【出】代價
小时的时间里	小時的時間【里】
软件开发环境	軟件開【發】環境
公开发行证券	公開【發】行證券
本次发行规模	本次【發】行規模
胡锦涛主席和	【胡】錦濤主席和
不是看到了吗	不是看到【了】嗎
去面对所有的	去【面】對所有的
以后会怎么样	以【後】會怎麼樣
推动两岸关系	推動兩岸關【係】
喷水灭火系统	噴水滅火【係】統
何尝不是如此	何【嘗】不是如此
注意投资风险	【注】意投資風險
能力倾向测验	能力傾【向】測驗
全面通货膨胀	全【面】通貨膨脹
鱼腥草注射液	魚腥草【注】射液
人才交流市场	人【才】交流市場
各方共同努力	各方共【同】努力
自己心里知道	自己心【里】知道
采用什么样的	【採】用什麼樣的
我心中只有你	我心中【只】有你
最后一场比赛	最【後】一場比賽
美国特种部队	美國特【種】部隊
出现不良反应	【出】現不良反應
负责人均表示	負責人均【表】示
发展科学技术	【發】展科學技【術】
库存管理系统	庫存管理【係】統
参与新股申购	【參】與新股申購
伊拉克共和国	伊拉【克】共和國
可以选择不同	可以選擇不【同】
俱乐部历史上	俱樂部【歷】史上
进行体育锻炼	進行體育鍛【煉】
聊了很长时间	聊【了】很長時間
最后一个赛季	最【後】一個賽季
最近喜欢上了	最近喜歡上【了】
外面的世界很	外【面】的世界很
在梦里见到你	在夢【里】見到你
特别引人注目	特【別】引人【注】目
几乎没有一个	【幾】乎沒有一個
据法新社报道	【據】法新社報道
和哈萨克斯坦	和哈薩【克】斯坦
进行手术治疗	進行手【術】治療
也是一种错误	也是一【種】錯誤
三国周郎赤壁	三國【周】郎赤壁
却不肯说出口	卻不肯說【出】口
朴素唯物主义	【樸】素唯物主義
这样就可以了	這樣就可以【了】
每天放学回家	每天放學【回】家
看见了没有啊	看見【了】沒有啊
遇到各种各样	遇到各【種】各樣
学科奥林匹克	學科奧林匹【克】
已经两个月了	已經兩個月【了】
专业招生计划	專業招生計【劃】
优先发展城市	優先【發】展城市
福克斯电视台	福【克】斯電視【臺】
没有血缘关系	沒有血緣關【係】
动画制作软件	動畫【制】作軟件
提出不同意见	提【出】不【同】意見
历史最好成绩	【歷】史最好成績
标准的普通话	標【準】的普通話
为什么不回答	爲什麼不【回】答
分手以后还会	分手以【後】還會
还以为你走了	還以爲你走【了】
的皇家马德里	的皇家馬德【里】
小天王周杰伦	小天王【周】【傑】倫
从事网络游戏	從事網絡【遊】戲
让人回味无穷	讓人【回】味無窮
手机单向收费	手機單【向】收費
实施交通管制	實施交通管【制】
破获刑事案件	破【獲】刑事案件
在里约热内卢	在【里】約熱內盧
给他们带来了	給他們帶來【了】
不幸中的大幸	不【幸】中的大【幸】
填报志愿时间	填報【志】願時間
一电影制片厂	一電影【制】片廠
城市生态系统	城市生態【係】統
占据重要地位	【佔】【據】重要地位
腾讯游戏频道	騰訊【遊】戲頻道
占有绝对优势	【佔】有絕對優勢
发生这样的事	【發】生這樣的事
陈芝麻烂谷子	陳芝麻爛【谷】子
克什米尔地区	【克】什米爾地區
游戏中的人物	【遊】戲中的人物
据新华社上海	【據】新華社上海
不禁感慨万千	不禁感慨【萬】【千】
同等学力考生	【同】等學力考生
比赛开始之后	比賽開始之【後】
斯里兰卡政府	斯【里】蘭卡政府
我忍不住哭了	我忍不住哭【了】
引起了大家的	引起【了】大家的
都灵冬奥会上	都靈【冬】奧會上
为了吸引更多	爲【了】吸引更多
其实也是一种	其實也是一【種】
最亲密的关系	最親密的關【係】
发表声明表示	【發】【表】聲明【表】示
发布会上透露	【發】【佈】會上透露
女生宿舍楼下	女生宿【舍】樓下
北京福利彩票	北京福利【彩】票
然后你就可以	然【後】你就可以
股份转让系统	股份轉讓【係】統
就没有意义了	就沒有意義【了】
买了一套房子	買【了】一套房子
网络游戏用户	網絡【遊】戲用戶
比赛精彩瞬间	比賽精【彩】瞬間
该怎样去面对	該怎樣去【面】對
硅谷动力消息	硅【谷】動力消息
发现自己竟然	【發】現自己竟然
睁只眼闭只眼	睜【只】眼閉【只】眼
业内专家表示	業內專家【表】示
恶性通货膨胀	【惡】性通貨膨脹
已经烟消云散	已經【煙】消【雲】散
还是忘不了你	還是忘不【了】你
技术上的问题	技【術】上的問題
黄金时间播出	黃金時間播【出】
东方艺术中心	東方藝【術】中心
有关方面正在	有關方【面】正在
俄克拉荷马州	俄【克】拉荷馬州
付出了沉重的	付【出】【了】沉重的
球星贝克汉姆	球星貝【克】漢姆
彻底的崩溃了	徹底的崩潰【了】
浏览更多精彩	瀏覽更多精【彩】
据中央气象台	【據】中央氣象【臺】
各种各样的人	各【種】各樣的人
发表研究报告	【發】【表】研究報告
发布会上了解	【發】【佈】會上【了】解
我才发现原来	我【才】【發】現原來
发展公共交通	【發】展公共交通
匹夫不可夺志	匹夫不可奪【志】
指纹识别系统	指紋識【別】【係】統
线性控制系统	線性控【制】【係】統
三里屯酒吧街	三【里】屯酒吧街
产业高峰论坛	產業高峰論【壇】
眼泪掉了下来	眼淚掉【了】下來
有着天壤之别	有著天壤之【別】
相当于现在的	相【當】於現在的
觉得理所当然	覺得理所【當】然
向流通股股东	【向】流通股股東
复方丹参滴丸	【復】方丹【參】滴丸
在未来几个月	在未來【幾】個月
特别股东大会	特【別】股東大會
林花谢了春红	林花謝【了】春紅
直布罗陀海峡	直【佈】羅陀海峽
奥林匹克五环	奧林匹【克】五環
最优秀的人才	最優秀的人【才】
国务院发言人	國務院【發】言人
行尸走肉一般	行【屍】走肉一般
集团的董事长	集【團】的董事長
微笑着去面对	微笑著去【面】對
我已经习惯了	我已經習慣【了】
现在在哪里啊	現在在哪【里】啊
因为某种原因	因爲某【種】原因
消费者带来了	消費者帶來【了】
液晶电视采用	液晶電視【採】用
人机控制系统	人機控【制】【係】統
下一个更精彩	下一個更精【彩】
一种说不出的	一【種】說不【出】的
为了爱梦一生	爲【了】愛夢一生
与哈萨克斯坦	與哈薩【克】斯坦
羟乙基纤维素	羥乙基【纖】維素
管不了那么多	管不【了】那麼多
农历正月初一	農【歷】正月初一
本报记者表示	本報記者【表】示
好久没有见了	好久沒有見【了】
阴暗的角落里	陰【暗】的角落【里】
谈判陷入僵局	談判陷入【僵】局
改善中日关系	改善中日關【係】
到底是做错了	到底是做錯【了】
实在受不了了	實在受不【了】【了】
网络游戏出版	網絡【遊】戲【出】版
自我控制能力	自我控【制】能力
我早已习惯了	我早已習慣【了】
不是靠这几天	不是靠這【幾】天
同比大幅增长	【同】比大幅增長
已经成为历史	已經成爲【歷】史
是非常复杂的	是非常【復】雜的
开心就可以了	開心就可以【了】
表示强烈抗议	【表】示強烈抗議
行政复议机关	行政【復】議機關
有历史意义的	有【歷】史意義的
最幸福的女人	最【幸】福的女人
渐渐的习惯了	漸漸的習慣【了】
共同感兴趣的	共【同】感興趣的
遥想公瑾当年	遙想公瑾【當】年
发布会上宣布	【發】【佈】會上宣【佈】
国际关系准则	國際關【係】【準】則
在讲话中表示	在講話中【表】示
一个完全不同	一個完全不【同】
一些负面影响	一些負【面】影響
资源信息系统	資源信息【係】統
在这样下去了	在這樣下去【了】
数据加密标准	數【據】加密標【準】
采写本报记者	【採】寫本報記者
系统编程语言	【係】統編程語言
我的电脑坏了	我的電腦壞【了】
必须注意的是	必【須】【注】意的是
你是我的幸福	你是我的【幸】福
去年同期加快	去年【同】期加快
经济运行数据	經濟運行數【據】
再也控制不住	再也控【制】不住
自己的注意力	自己的【注】意力
我们也注意到	我們也【注】意到
尽人事听天命	【盡】人事聽天命
代表中国参加	代【表】中國【參】加
全世界只有我	全世界【只】有我
让人刮目相看	讓人【刮】目相看
研讨会上表示	研討會上【表】示
刮了一天的风	【刮】【了】一天的風
万般无奈之下	【萬】般無奈之下
一个月过去了	一個月過去【了】
也是一种享受	也是一【種】享受
的时候发现了	的時候【發】現【了】
面临巨大压力	【面】臨巨大壓力
要怎么说出口	要怎麼說【出】口
你结婚了没有	你結婚【了】沒有
发生透水事故	【發】生透水事故
可以分为两种	可以分爲兩【種】
同发展中国家	【同】【發】展中國家
相当大的影响	相【當】大的影響
警察发生冲突	警察【發】生【衝】突
淫秽色情表演	淫穢色情【表】演
更多精彩组图	更多精【彩】組圖
成为亿万富翁	成爲億【萬】富翁
忍不住流下了	忍不住流下【了】
考生参加高考	考生【參】加高考
小额支付系统	小額支付【係】統
我的个性签名	我的個性【籖】名
双方一致认为	雙方一【致】認爲
统计结果表明	統計結果【表】明
发挥出应有的	【發】揮【出】應有的
两种完全不同	兩【種】完全不【同】
为大家提供了	爲大家提供【了】
你会发现自己	你會【發】現自己
以免发生意外	以免【發】生意外
只是自欺欺人	【只】是自欺欺人
大学生毕业后	大學生畢業【後】
同声传译设备	【同】聲傳譯設備
慢慢的学会了	慢慢的學會【了】
特别是在中国	特【別】是在中國
发生过性关系	【發】生過性關【係】
总有一种力量	總有一【種】力量
引发交通事故	引【發】交通事故
最美丽的新娘	最美麗的新【娘】
进入网络游戏	進入網絡【遊】戲
氨基酸注射液	氨基酸【注】射液
通过定向增发	通過定【向】增【發】
粒细胞缺乏症	粒細胞缺乏【症】
的汽车制造商	的汽車【制】造商
盐酸克林霉素	鹽酸【克】林霉素
和平稳定发展	和平穩定【發】展
我马上要走了	我馬上要走【了】
技术经济评价	技【術】經濟評價
太阳系外行星	太陽【係】外行星
引发轩然大波	引【發】軒然大波
丧钟为谁而鸣	喪【鍾】爲誰而鳴
面对喜欢的人	【面】對喜歡的人
在赛季结束后	在賽季結束【後】
他们并不知道	他們【並】不知道
我以为你走了	我以爲你走【了】
给自己找借口	給自己找【借】口
内政部发言人	內政部【發】言人
外务省发言人	外務省【發】言人
十多年过去了	十多年過去【了】
发生山体滑坡	【發】生山體滑坡
背上了沉重的	背上【了】沉重的
出席了发布会	【出】席【了】【發】【佈】會
环节出了问题	環節【出】【了】問題
注意力转移到	【注】意力轉移到
你现在在干吗	你現在在【幹】嗎
身体上睡着了	身體上睡著【了】
首当其冲的是	首【當】其【衝】的是
勇敢地去面对	勇敢地去【面】對
那么理所当然	那麼理所【當】然
电子游戏软件	電子【遊】戲軟件
竖起了大拇指	豎起【了】大拇指
十年后的今天	十年【後】的今天
感染猪链球菌	感染豬【鏈】球菌
什么也没发生	什麼也沒【發】生
只有你才能让	【只】有你【才】能讓
这个过程当中	這個過程【當】中
为了让自己的	爲【了】讓自己的
作出严肃处理	作【出】嚴肅處理
付出我的生命	付【出】我的生命
永远幸福快乐	永遠【幸】福快樂
帕金森综合症	帕金森綜合【症】
公司定向增发	公司定【向】增【發】
邮政体制改革	郵政體【制】改革
集团副董事长	集【團】副董事長
即将参加高考	即將【參】加高考
呼吁有关部门	呼【籲】有關部門
据新华社消息	【據】新華社消息
已经明确表示	已經明確【表】示
斯诺克世锦赛	斯諾【克】世錦賽
很幸福很快乐	很【幸】福很快樂
的时间并不长	的時間【並】不長
残奥会志愿者	殘奧會【志】願者
采取军事行动	【採】取軍事行動
据香港大公报	【據】香港大公報
再也没有回来	再也沒有【回】來
还有没有别的	還有沒有【別】的
将面临更大的	將【面】臨更大的
怎么一回事呢	怎麼一【回】事呢
第一次出现了	第一次【出】現【了】
发生在巴格达	【發】生在巴格達
并不尽如人意	【並】不【盡】如人意
现在我才知道	現在我【才】知道
农业生态系统	農業生態【係】統
了不起的成就	【了】不起的成就
并且可以通过	【並】且可以通過
每当夜幕降临	每【當】夜幕降臨
断绝父子关系	斷絕父子關【係】
证据的情况下	證【據】的情況下
据知情者透露	【據】知情者透露
骨髓移植手术	骨髓移植手【術】
全面战略合作	全【面】戰略合作
也没什么特别	也沒什麼特【別】
最低录取控制	最低錄取控【制】
欧佩克成员国	歐佩【克】成員國
系列运载火箭	【係】列運載火箭
我要去洗澡了	我要去洗澡【了】
什么也没有了	什麼也沒有【了】
男朋友分手了	男朋友分手【了】
科学家们发现	科學家們【發】現
在过去几年中	在過去【幾】年中
空调温度控制	空調溫度控【制】
丰富的维他命	【豐】富的維他命
很长时间才能	很長時間【才】能
逐渐显现出来	逐漸顯現【出】來
没有别的意思	沒有【別】的意思
由北向南行驶	由北【向】南行駛
人大代表职务	人大代【表】職務
出租汽车司机	【出】租汽車司機
相当长时间内	相【當】長時間內
我明白了一切	我明白【了】一切
发布会上回答	【發】【佈】會上【回】答
采取进一步的	【採】取進一步的
风险控制指标	風險控【制】指標
重点关注的对	重點關【注】的對
系统控制程序	【係】統控【制】程序
由共青团中央	由共青【團】中央
中国邮政集团	中國郵政集【團】
喜欢胡思乱想	喜歡【胡】思亂想
占据绝对优势	【佔】【據】絕對優勢
都不好意思了	都不好意思【了】
首都机场集团	首都機場集【團】
更轻松的开始	更輕【鬆】的開始
早在几个月前	早在【幾】個月前
抛到九霄云外	拋到九霄【雲】外
就给我发信息	就給我【發】信息
我喝了很多酒	我喝【了】很多酒
知道怎样才能	知道怎樣【才】能
宣布这一消息	宣【佈】這一消息
我心里很明白	我心【里】很明白
花了很多时间	花【了】很多時間
数字电视地面	數字電視地【面】
专家分析指出	專家分析指【出】
有没有注意到	有沒有【注】意到
看外面的世界	看外【面】的世界
发发发发发发	【發】【發】【發】【發】【發】【發】
舍小家为大家	【舍】小家爲大家
有点接受不了	有點接受不【了】
对中国出口的	對中國【出】口的
最明显的特征	最明顯的特【徵】
大家的注意力	大家的【注】意力
今天怎么了啊	今天怎麼【了】啊
人民法院核准	人民法院核【準】
昏暗的灯光下	昏【暗】的燈光下
香港经济发展	香港經濟【發】展
在克里姆林宫	在【克】【里】姆林宮
投资者特别是	投資者特【別】是
真是郁闷死了	真是【鬱】悶死【了】
难道是我错了	難道是我錯【了】
每当我闭上眼	每【當】我閉上眼
一项研究发现	一項研究【發】現
控制党政机关	控【制】【黨】政機關
产生抑制作用	產生抑【制】作用
相当大一部分	相【當】大一部分
环境信息系统	環境信息【係】統
社会学系教授	社會學【係】教授
一种撕心裂肺	一【種】撕心裂肺
农业合作论坛	農業合作論【壇】
坐在沙发上看	坐在沙【發】上看
美国在伊拉克	美國在伊拉【克】
夏日里的春天	夏日【里】的春天
在很多人眼里	在很多人眼【里】
几乎可以说是	【幾】乎可以說是
我军历史使命	我軍【歷】史使命
从国家发改委	從國家【發】改委
我爱的人幸福	我愛的人【幸】福
气息扑面而来	氣息撲【面】而來
接受电话采访	接受電話【採】訪
还没有回来啊	還沒有【回】來啊
还是因为别的	還是因爲【別】的
接受手术治疗	接受手【術】治療
忘不了我们有	忘不【了】我們有
十分引人注目	十分引人【注】目
留下了美好的	留下【了】美好的
你不说就算了	你不說就算【了】
批准的情况下	批【準】的情況下
就这么过来了	就這麼過來【了】
我终于回来了	我終於【回】來【了】
合作伙伴之一	合作【夥】伴之一
据信息产业部	【據】信息產業部
花费了大量的	花費【了】大量的
数据的一致性	數【據】的一【致】性
这是一个相当	這是一個相【當】
写的怎么样了	寫的怎麼樣【了】
仅仅只是一个	僅僅【只】是一個
纽约州参议员	紐約州【參】議員
双方一致同意	雙方一【致】【同】意
扎实的基本功	【扎】實的基本功
教育部公布的	教育部公【佈】的
作为合作伙伴	作爲合作【夥】伴
另据记者了解	另【據】記者【了】解
决定上层建筑	決定上層建【築】
同期上证指数	【同】期上證指數
只是一小部分	【只】是一小部分
晴到多云天气	晴到多【雲】天氣
一步一步走向	一步一步走【向】
四冲程发动机	四【衝】程【發】動機
的伊拉克战争	的伊拉【克】戰爭
检测结果表明	檢測結果【表】明
美军在伊拉克	美軍在伊拉【克】
采用了独特的	【採】用【了】獨特的
通信系统设计	通信【係】統設計
同属一个中国	【同】屬一個中國
经过调查发现	經過調查【發】現
统计数据来看	統計數【據】來看
据香港文汇报	【據】香港文【匯】報
纳斯达克市场	納斯達【克】市場
老翅几回寒暑	老翅【幾】【回】寒暑
可能会出现的	可能會【出】現的
笑得前仰后合	笑得前仰【後】合
为了节省时间	爲【了】節省時間
我就不理你了	我就不理你【了】
开幕式上发表	開幕式上【發】【表】
这里就不多说	這【里】就不多說
在你面前也会	在你【面】前也會
发布违法广告	【發】【佈】違法廣告
技术经济论证	技【術】經濟論證
多款网络游戏	多款網絡【遊】戲
和伊拉克战争	和伊拉【克】戰爭
当地卫生部门	【當】地衛生部門
更多精彩资讯	更多精【彩】資訊
一发而不可收	一【發】而不可收
昨天发布公告	昨天【發】【佈】公告
柏林爱乐乐团	柏林愛樂樂【團】
整天游手好闲	整天【遊】手好閑
经风雨见世面	經風雨見世【面】
运载火箭技术	運載火箭技【術】
本身也是一种	本身也是一【種】
助力转向系统	助力轉【向】【係】統
临时交通管制	臨時交通管【制】
最简单的幸福	最簡單的【幸】福
作为网络游戏	作爲網絡【遊】戲
提出反对意见	提【出】反對意見
军地两用人才	軍地兩用人【才】
据中国青年报	【據】中國青年報
你来了多久了	你來【了】多久【了】
因为工作关系	因爲工作關【係】
实在忍受不了	實在忍受不【了】
梦回吹角连营	夢【回】吹角連營
烦死了烦死了	煩死【了】煩死【了】
盐湖城冬奥会	鹽湖城【冬】奧會
数字集团电话	數字集【團】電話
完全是两回事	完全是兩【回】事
遵守游戏规则	遵守【遊】戲規則
外汇储备资产	外【匯】儲備資產
国台办发言人	國【臺】辦【發】言人
飞行控制中心	飛行控【制】中心
获奖名单如下	【獲】獎名單如下
变得丰富多彩	變得【豐】富多【彩】
我就要回家了	我就要【回】家【了】
中国北车集团	中國北車集【團】
迅速作出反应	迅速作【出】反應
形成了强烈的	形成【了】強烈的
已经所剩无几	已經所剩無【幾】
在黑暗中摸索	在黑【暗】中摸索
互不干涉内政	互不【幹】涉內政
老板亚历山大	老【板】亞【歷】山大
又重新回到了	又重新【回】到【了】
哪怕只有一次	哪怕【只】有一次
越来越漂亮了	越來越漂亮【了】
中共中央台办	中共中央【臺】辦
两党两国关系	兩【黨】兩國關【係】
的时间太长了	的時間太長【了】
有限的时间里	有限的時間【里】
不到回家的路	不到【回】家的路
一打听才知道	一打聽【才】知道
心脏移植手术	心【髒】移植手【術】
就已经足够了	就已經足夠【了】
一种从未有过	一【種】從未有過
校园篮球风云	校園籃球風【雲】
怎么样去面对	怎麼樣去【面】對
理所当然的事	理所【當】然的事
内蒙古东北部	內【蒙】古東北部
就是几个小时	就是【幾】個小時
承受不了这样	承受不【了】這樣
继续向前发展	繼續【向】前【發】展
赛诺菲安万特	賽諾菲安【萬】特
几家欢乐几家	【幾】家歡樂【幾】家
我爱上了一个	我愛上【了】一個
确定恋爱关系	確定戀愛關【係】
犹太复国主义	猶太【復】國主義
内蒙古中东部	內【蒙】古中東部
只有一个想法	【只】有一個想法
党内警告处分	【黨】內警告處分
春秋航空公司	春【秋】航空公司
充满传奇色彩	充滿傳奇色【彩】
后才知道珍惜	【後】【才】知道珍惜
未成年人出售	未成年人【出】售
综合台湾媒体	綜合【臺】灣媒體
只有一个目的	【只】有一個目的
也是一种快乐	也是一【種】快樂
我在家里上网	我在家【里】上網
什么也做不了	什麼也做不【了】
扶不起的阿斗	扶不起的阿【鬭】
推出的第一款	推【出】的第一款
翻了个底朝天	翻【了】個底朝天
国家管理制度	國家管理【制】度
中国民族游戏	中國民族【遊】戲
主机操作系统	主機操作【係】統
塔利班发言人	塔利班【發】言人
一天到晚游泳	一天到晚【遊】泳
发现自己真的	【發】現自己真的
已经荡然无存	已經【蕩】然無存
怎么又回来了	怎麼又【回】來【了】
数据统计显示	數【據】統計顯示
在回去的路上	在【回】去的路上
是种什么感觉	是【種】什麼感覺
感染了艾滋病	感染【了】艾滋病
异曲同工之处	異【曲】【同】工之處
欣赏更多精彩	欣賞更多精【彩】
广大台湾同胞	廣大【臺】灣【同】胞
高低压开关柜	高低壓開關【櫃】
感觉到了幸福	感覺到【了】【幸】福
台湾海峡两岸	【臺】灣海峽兩岸
所以我选择了	所以我選擇【了】
中国台北选手	中國【臺】北選手
德克诺维茨基	德【克】諾維茨基
说不出话来了	說不【出】話來【了】
最后还是决定	最【後】還是決定
公布调查结果	公【佈】調查結果
应该尽量避免	應該【盡】量避免
一下子变成了	一下子變成【了】
五千年的历史	五【千】年的【歷】史
十大网络游戏	十大網絡【遊】戲
组成的代表团	組成的代【表】【團】
办公室发言人	辦公室【發】言人
保存就可以了	保存就可以【了】
登陆纳斯达克	登陸納斯達【克】
贫困大学生的	貧【困】大學生的
参议员希拉里	【參】議員希拉【里】
并不认为自己	【並】不認爲自己
就可以回家了	就可以【回】家【了】
出现什么情况	【出】現什麼情況
发展自主品牌	【發】展自主品牌
又见一帘幽梦	又見一【簾】幽夢
全党全军全国	全【黨】全軍全國
直属师范大学	直屬師【範】大學
由于工作关系	由於工作關【係】
对你情有独钟	對你情有獨【鍾】
只是我个人的	【只】是我個人的
发布医疗广告	【發】【佈】醫療廣告
控制温室气体	控【制】溫室氣體
泪水夺眶而出	淚水奪眶而【出】
伊拉克大使馆	伊拉【克】大使館
的事怎么样了	的事怎麼樣【了】
沉迷系统开发	沉迷【係】統開【發】
克里姆林宫的	【克】【里】姆林宮的
何尝不是一种	何【嘗】不是一【種】
只需要一秒钟	【只】需要一秒【鍾】
博采众家之长	博【採】眾家之長
全世界最幸福	全世界最【幸】福
开始了漫长的	開始【了】漫長的
最后还是只剩	最【後】還是【只】剩
游戏制作公司	【遊】戲【制】作公司
完成招生计划	完成招生計【劃】
据这位负责人	【據】這位負責人
只是一个方面	【只】是一個方【面】
销量同比增长	銷量【同】比增長
的时间不多了	的時間不多【了】
光学字符识别	光學字符識【別】
说好了不回头	說好【了】不【回】頭
留下了自己的	留下【了】自己的
交感神经系统	交感神經【係】統
几乎感觉不到	【幾】乎感覺不到
并不在乎自己	【並】不在乎自己
短短的几个月	短短的【幾】個月
算得了什么呢	算得【了】什麼呢
谁才是真正的	誰【才】是真正的
头也不回地走	頭也不【回】地走
必须全力以赴	必【須】全力以赴
的身份出现在	的身份【出】現在
它含有丰富的	它含有【豐】富的
抑制不住内心	抑【制】不住內心
抽象数据类型	抽象數【據】類型
稳定控制系统	穩定控【制】【係】統
皇家马德里的	皇家馬德【里】的
目的只是为了	目的【只】是爲【了】
你在干什么呀	你在【幹】什麼呀
有关人员表示	有關人員【表】示
我才恍然大悟	我【才】恍然大悟
支气管扩张症	支氣管擴張【症】
这款摩托罗拉	這款摩【托】羅拉
相关部门获悉	相關部門【獲】悉
骂人不带脏字	罵人不帶【髒】字
没有人注意到	沒有人【注】意到
在佛罗里达州	在佛羅【里】達州
采取法律行动	【採】取法律行動
嵌入式控制器	嵌入式控【制】器
只希望我能够	【只】希望我能夠
不是同一个人	不是【同】一個人
的时间过去了	的時間過去【了】
战争爆发以来	戰爭爆【發】以來
我不是很了解	我不是很【了】解
你不是要下了	你不是要下【了】
中国公民旅游	中國公民旅【遊】
俄克拉何马州	俄【克】拉何馬州
还不是很了解	還不是很【了】解
提到了嗓子眼	提到【了】嗓子眼
行政复议机构	行政【復】議機構
你是哪里的呀	你是哪【里】的呀
我的心里装着	我的心【里】裝著
为大家带来了	爲大家帶來【了】
我马上就下了	我馬上就下【了】
队伍不好带了	隊伍不好帶【了】
只是其中一个	【只】是其中一個
外汇资金境外	外【匯】資金境外
发现了新大陆	【發】現【了】新大陸
我现在才知道	我現在【才】知道
意外地发现了	意外地【發】現【了】
根据国际惯例	根【據】國際慣例
经过精心策划	經過精心策【劃】
这个物欲横流	這個物【欲】橫流
大汽车制造商	大汽車【制】造商
早已烟消云散	早已【煙】消【雲】散
数据分析系统	數【據】分析【係】統
两个截然不同	兩個截然不【同】
三步并作两步	三步【並】作兩步
在适当的时间	在適【當】的時間
再也看不到了	再也看不到【了】
了不起的事情	【了】不起的事情
最低生活标准	最低生活標【準】
就是这么回事	就是這麼【回】事
尤其值得关注	尤其值得關【注】
销售人员表示	銷售人員【表】示
有志不在年高	有【志】不在年高
表示坚决反对	【表】示堅決反對
正在采取措施	正在【採】取措施
也许若干年后	也許若【幹】年【後】
万国邮政联盟	【萬】國郵政聯盟
我并不是天生	我【並】不是天生
迅速采取行动	迅速【採】取行動
人类补完计划	人類補完計【劃】
内蒙古中西部	內【蒙】古中西部
为了他放弃了	爲【了】他放棄【了】
数据格式转换	數【據】格式轉換
好想好想回到	好想好想【回】到
从口袋里拿出	從口袋【里】拿【出】
出于什么目的	【出】於什麼目的
世乒赛团体赛	世乒賽【團】體賽
好久没有上了	好久沒有上【了】
立即采取行动	立即【採】取行動
确有悔改表现	確有悔改【表】現
浪费了宝贵的	浪費【了】寶貴的
出于什么原因	【出】於什麼原因
留下只言片语	留下【只】言片語
向记者证实了	【向】記者證實【了】
会尽最大努力	會【盡】最大努力
数据库完整性	數【據】庫完整性
狗改不了吃屎	狗改不【了】吃屎
来说也是一种	來說也是一【種】
而据记者了解	而【據】記者【了】解
做到尽善尽美	做到【盡】善【盡】美
在现场了解到	在現場【了】解到
我是真的累了	我是真的纍【了】
水生生态系统	水生生態【係】統
只能硬着头皮	【只】能硬著頭皮
付出了很大的	付【出】【了】很大的
法兰克福股市	法蘭【克】福股市
在某种情况下	在某【種】情況下
第一网络游戏	第一網絡【遊】戲
艾滋病规划署	艾滋病規【劃】署
几十年过去了	【幾】十年過去【了】
车城网友论坛	車城網友論【壇】
肺原性心脏病	肺原性心【髒】病
你吃了没有啊	你吃【了】沒有啊
生命保障系统	生命保障【係】統
吃饭了没有啊	吃飯【了】沒有啊
打电话你那里	打電話你那【里】
抱着侥幸心理	抱著僥【幸】心理
你给我发信息	你給我【發】信息
队长贝克汉姆	隊長貝【克】漢姆
蒙特塞拉特岛	【蒙】特塞拉特島
伊拉克逊尼派	伊拉【克】遜尼派
采取法律手段	【採】取法律手段
就是控制不了	就是控【制】不【了】
随时可能出现	隨時可能【出】現
出现在我眼前	【出】現在我眼前
只是说说而已	【只】是說說而已
武侠网络游戏	武俠網絡【遊】戲
台湾团结联盟	【臺】灣【團】結聯盟
只是暂时离开	【只】是暫時離開
只要有一个人	【只】要有一個人
是我最后一次	是我最【後】一次
视窗操作系统	視窗操作【係】統
两个人的幸运	兩個人的【幸】運
别想那么多了	【別】想那麼多【了】
事情已经发生	事情已經【發】生
学然后知不足	學然【後】知不足
洗得干干净净	洗得【幹】【幹】凈凈
得出这样一个	得【出】這樣一個
心里不是滋味	心【里】不是滋味
没什么意思了	沒什麼意思【了】
在伊拉克问题	在伊拉【克】問題
争得面红耳赤	爭得【面】紅耳赤
发展两国关系	【發】展兩國關【係】
大摇大摆地走	大搖大【擺】地走
小时工资标准	小時工資標【準】
你这是干什么	你這是【幹】什麼
晚上睡不着了	晚上睡不著【了】
只有一次机会	【只】有一次機會
虽然只是一个	雖然【只】是一個
我并不是一个	我【並】不是一個
共和党候选人	共和【黨】候選人
影响两国关系	影響兩國關【係】
灭菌注射用水	滅菌【注】射用水
你们怎么样了	你們怎麼樣【了】
面对即将到来	【面】對即將到來
游戏产业发展	【遊】戲產業【發】展
让人欲罢不能	讓人【欲】罷不能
只有一个宝贝	【只】有一個寶貝
参加世界杯赛	【參】加世界杯賽
平均发展速度	平均【發】展速度
吉利控股集团	吉利控股集【團】
我要走了下次	我要走【了】下次
五花马千金裘	五花馬【千】金裘
其实只是一个	其實【只】是一個
国际开发协会	國際開【發】協會
数据终端设备	數【據】終端設備
尤其引人注目	尤其引人【注】目
参加这个活动	【參】加這個活動
根本看不出来	根本看不【出】來
当地环保部门	【當】地環保部門
干打雷不下雨	【幹】打雷不下雨
参加全国统考	【參】加全國統考
开始着手准备	開始著手【準】備
边际消费倾向	邊際消費傾【向】
晚上不回去了	晚上不【回】去【了】
可以轻轻松松	可以輕輕【鬆】【鬆】
出现在她面前	【出】現在她【面】前
我也没办法了	我也沒辦法【了】
明天太阳升起	明天太陽【升】起
朋友一起出来	朋友一起【出】來
出现在屏幕上	【出】現在屏幕上
制止家庭暴力	【制】止家庭暴力
我一会就下了	我一會就下【了】
发展民族经济	【發】展民族經濟
涡轮轴发动机	渦輪軸【發】動機
心中只有一个	心中【只】有一個
数据加密密钥	數【據】加密密鑰
网络游戏企业	網絡【遊】戲企業
如果只是为了	如果【只】是爲【了】
只要曾经拥有	【只】要曾經擁有
外汇储备规模	外【匯】儲備規模
出现的可能性	【出】現的可能性
看到精彩内容	看到精【彩】內容
采访的过程中	【採】訪的過程中
计划没有变化	計【劃】沒有變化
了新华社记者	【了】新華社記者
谁的心忘了收	誰的心忘【了】收
一点技术含量	一點技【術】含量
眼泪夺眶而出	眼淚奪眶而【出】
说不清的冲突	說不清的【衝】突
成为一名出色	成爲一名【出】色
每天早出晚归	每天早【出】晚歸
另一方面来说	另一方【面】來說
公司发布公告	公司【發】【佈】公告
的价格购买了	的價格購買【了】
我给你发短信	我給你【發】短信
没有共同语言	沒有共【同】語言
到时候再说了	到時候再說【了】
好久没见了啊	好久沒見【了】啊
国务院参事室	國務院【參】事室
留个联系方式	留個聯【係】方式
一直备受关注	一直備受關【注】
回忆起当时的	【回】憶起【當】時的
我要去玩游戏	我要去玩【遊】戲
说出你的秘密	說【出】你的秘密
中国手机游戏	中國手機【遊】戲
越来越倾向于	越來越傾【向】於
我有事要走了	我有事要走【了】
自己做了什么	自己做【了】什麼
试驾凯迪拉克	試駕凱迪拉【克】
可以重点关注	可以重點關【注】
只是因为害怕	【只】是因爲害怕
经济信息系统	經濟信息【係】統
数据传输方面	數【據】傳輸方【面】
集团内部人士	集【團】內部人士
学的怎么样了	學的怎麼樣【了】
没有心理准备	沒有心理【準】備
到了那个时候	到【了】那個時候
国务院法制局	國務院法【制】局
我要回家了啊	我要【回】家【了】啊
离退休老同志	離退休老【同】【志】
训练结束之后	訓練結束之【後】
本来就是一种	本來就是一【種】
饿死了饿死了	餓死【了】餓死【了】
就完全不同了	就完全不【同】【了】
退休后的生活	退休【後】的生活
民主党参议员	民主【黨】【參】議員
出租车行业的	【出】租車行業的
为了完成任务	爲【了】完成任務
自己的心里话	自己的心【里】話
很有可能出现	很有可能【出】現
怎么也走不出	怎麼也走不【出】
碰了一鼻子灰	碰【了】一鼻子灰
面对最爱的人	【面】對最愛的人
中国农历新年	中國農【歷】新年
我现在在苏州	我現在在【蘇】州
颈椎间盘突出	頸椎間盤突【出】
体育场进行了	體育場進行【了】
我已经长大了	我已經長大【了】
好想回到从前	好想【回】到從前
出台相关规定	【出】【臺】相關規定
八国集团首脑	八國集【團】首腦
女孩最后一次	女孩最【後】一次
天天在一起了	天天在一起【了】
负责人则表示	負責人則【表】示
但从另一方面	但從另一方【面】
发言人办公室	【發】言人辦公室
行尸走肉一样	行【屍】走肉一樣
几乎不敢相信	【幾】乎不敢相信
千载难逢的好	【千】載難逢的好
南方周末记者	南方【周】末記者
一点也不夸张	一點也不【誇】張
历届领导班子	【歷】屆領導班子
我在等你回来	我在等你【回】來
与外界的联系	與外界的聯【係】
出席八国集团	【出】席八國集【團】
我以为只要我	我以爲【只】要我
为五斗米折腰	爲五【鬭】米【折】腰
另一个世界里	另一個世界【里】
的目的达到了	的目的達到【了】
早报记者表示	早報記者【表】示
为了方便群众	爲【了】方便群眾
布拉格斯巴达	【佈】拉格斯巴達
储户问卷调查	儲戶問【捲】調查
定向增发方案	定【向】增【發】方案
行云流水般的	行【雲】流水般的
只是过眼云烟	【只】是過眼【雲】【煙】
伊拉克领导人	伊拉【克】領導人
并非一朝一夕	【並】非一朝一夕
然而不幸的是	然而不【幸】的是
发行价格区间	【發】行價格區間
约占海关税则	約【佔】海關稅則
很可能会出现	很可能會【出】現
生活多姿多彩	生活多姿多【彩】
更加绚丽多彩	更加絢麗多【彩】
新闻发言人崇	新聞【發】言人崇
摸了摸自己的	摸【了】摸自己的
语言表达出来	語言【表】達【出】來
断绝外交关系	斷絕外交關【係】
也方便了不少	也方便【了】不少
各种交通工具	各【種】交通工具
调查报告指出	調查報告指【出】
只股票型基金	【只】股票型基金
图为摩托罗拉	圖爲摩【托】羅拉
有什么关系啊	有什麼關【係】啊
统计质量控制	統計質量控【制】
出现中毒症状	【出】現中毒【症】狀
你给我的回忆	你給我的【回】憶
一万个够不够	一【萬】個夠不夠
面向对象建模	【面】【向】對象建模
爱你永不后悔	愛你永不【後】悔
火车站派出所	火車站派【出】所
却不尽如人意	卻不【盡】如人意
突然冒出一句	突然冒【出】一句
早有心理准备	早有心理【準】備
最新游戏画面	最新【遊】戲畫【面】
新历史教科书	新【歷】史教科書
招待会上表示	招待會上【表】示
我们别无选择	我們【別】無選擇
省教育厅获悉	省教育廳【獲】悉
醋酸地塞米松	醋酸地塞米【鬆】
话又说回来了	話又說【回】來【了】
斯托贾科维奇	斯【托】賈科維奇
一枝红杏出墙	一枝紅杏【出】牆
当地时间下午	【當】地時間下午
他们在哪里呀	他們在哪【里】呀
在发布会现场	在【發】【佈】會現場
液晶电视面板	液晶電視【面】【板】
参加全国普通	【參】加全國普通
一种自我安慰	一【種】自我安慰
不管以后我们	不管以【後】我們
中国平板电视	中國平【板】電視
得了便宜卖乖	得【了】便宜賣乖
一点就可以了	一點就可以【了】
这种情况之下	這【種】情況之下
在上海大舞台	在上海大舞【臺】
获得小组第一	【獲】得小組第一
了不起的人物	【了】不起的人物
五台山体育馆	五【臺】山體育館
发生的一件事	【發】生的一件事
为此付出代价	爲此付【出】代價
当然这些都是	【當】然這些都是
代表团副团长	代【表】【團】副【團】長
值得密切关注	值得密切關【注】
销售额达到了	銷售額達到【了】
也没什么关系	也沒什麼關【係】
回答一个问题	【回】答一個問題
前言不搭后语	前言不搭【後】語
也方便了大家	也方便【了】大家
由西向东行驶	由西【向】東行駛
大不了的事情	大不【了】的事情
都没有注意到	都沒有【注】意到
把自己嫁出去	把自己嫁【出】去
在过去几年里	在過去【幾】年【里】
心里只有一个	心【里】【只】有一個
昨天记者获悉	昨天記者【獲】悉
银汉迢迢暗度	銀漢迢迢【暗】度
大学毕业之后	大學畢業之【後】
灾难恢复计划	災難恢【復】計【劃】
如果只是寂寞	如果【只】是寂寞
食物中毒症状	食物中毒【症】狀
成为当之无愧	成爲【當】之無愧
也向记者表示	也【向】記者【表】示
美军特种部队	美軍特【種】部隊
你是干什么的	你是【幹】什麼的
网状内皮系统	網狀內皮【係】統
福建省气象台	福建省氣象【臺】
为了以防万一	爲【了】以防【萬】一
回到家的时候	【回】到家的時候
分手了以后就	分手【了】以【後】就
我去玩游戏了	我去玩【遊】戲【了】
又过了一年了	又過【了】一年【了】
不是生离死别	不是生離死【別】
电池系统使用	電池【係】統使用
我就不客气了	我就不客氣【了】
这个消息发送	這個消息【發】送
恢复外交关系	恢【復】外交關【係】
输卵管结扎术	輸卵管結【扎】【術】
休闲游戏平台	休閑【遊】戲平【臺】
当天早些时候	【當】天早些時候
再过几天就是	再過【幾】天就是
的柴油发动机	的柴油【發】動機
主要货币汇率	主要貨幣【匯】率
控制住自己的	控【制】住自己的
协议数据单元	協議數【據】單元
意义非同寻常	意義非【同】尋常
面对越来越多	【面】對越來越多
又是一个冬天	又是一個【冬】天
一项调查发现	一項調查【發】現
各有巧妙不同	各有巧妙不【同】
我才知道自己	我【才】知道自己
关系数据模型	關【係】數【據】模型
半天说不出话	半天說不【出】話
我心里好难过	我心【里】好難過
吸引了不少人	吸引【了】不少人
为了你为了我	爲【了】你爲【了】我
同一水平线上	【同】一水平線上
由东向西行驶	由東【向】西行駛
一回生二回熟	一【回】生二【回】熟
电视台报道说	電視【臺】報道說
我的世界只有	我的世界【只】有
笔记本采用了	筆記本【採】用【了】
学术不端行为	學【術】不端行爲
牺牲了自己的	犧牲【了】自己的
果然不同凡响	果然不【同】凡響
数据操纵语言	數【據】操縱語言
千年等一回的	【千】年等一【回】的
也不是万能的	也不是【萬】能的
推动中日关系	推動中日關【係】
出乎所有人的	【出】乎所有人的
不了解自己的	不【了】解自己的
刚刚参加工作	剛剛【參】加工作
发现无法下载	【發】現無法下載
根据中国证券	根【據】中國證券
是什么意思了	是什麼意思【了】
发生了微妙的	【發】生【了】微妙的
对你刮目相看	對你【刮】目相看
整天胡思乱想	整天【胡】思亂想
陷入恶性循环	陷入【惡】性循環
输精管结扎术	輸精管結【扎】【術】
一个月时间里	一個月時間【里】
据俄罗斯媒体	【據】俄羅斯媒體
第一次见面时	第一次見【面】時
联通彩铃下载	聯通【彩】鈴下載
你不是走了吗	你不是走【了】嗎
你现在到那里	你現在到那【里】
休闲娱乐平台	休閑娛樂平【臺】
你在干什么呢	你在【幹】什麼呢
正在密切关注	正在密切關【注】
死马当活马医	死馬【當】活馬醫
注定要失败的	【注】定要失敗的
你刚才说什么	你剛【才】說什麼
发生爆炸事件	【發】生爆炸事件
最后的胜利者	最【後】的勝利者
我都看见你了	我都看見你【了】
完善市场机制	完善市場機【制】
会想起他心里	會想起他心【里】
成立了专案组	成立【了】專案組
行百里半九十	行百【里】半九十
到底在干什么	到底在【幹】什麼
共同战略目标	共【同】戰略目標
你来了好久了	你來【了】好久【了】
出租汽车企业	【出】租汽車企業
打动了我的心	打動【了】我的心
次代表国家队	次代【表】國家隊
本周早些时候	本【周】早些時候
对此表示欢迎	對此【表】示歡迎
伊拉克伊斯兰	伊拉【克】伊斯蘭
视为理所当然	視爲理所【當】然
百胜餐饮集团	百勝餐飲集【團】
说一千道一万	說一【千】道一【萬】
防范市场风险	防【範】市場風險
家丑不可外扬	家【醜】不可外揚
俱乐部进行了	俱樂部進行【了】
人生只有一次	人生【只】有一次
事务处理系统	事務處理【係】統
跟别人不一样	跟【別】人不一樣
你给我发过来	你給我【發】過來
好男人的标准	好男人的標【準】
你还是离开了	你還是離開【了】
没有表现出来	沒有【表】現【出】來
公司的发言人	公司的【發】言人
国际社会必须	國際社會必【須】
形象大打折扣	形象大打【折】扣
眼泪说不出的	眼淚說不【出】的
这时我才发现	這時我【才】【發】現
并行程序设计	【並】行程序設計
并非一无是处	【並】非一無是處
男孩最后一次	男孩最【後】一次
浙江省气象台	浙江省氣象【臺】
温布利大师赛	溫【佈】利大師賽
磁盘操作系统	磁盤操作【係】統
对此表示感谢	對此【表】示感謝
疫苗预防接种	疫苗預防接【種】
全世界的关注	全世界的關【注】
并不是第一次	【並】不是第一次
抹了一把冷汗	抹【了】一把冷汗
无法回到过去	無法【回】到過去
电脑屏幕发呆	電腦屏幕【發】呆
都没有上网了	都沒有上網【了】
比赛结束之后	比賽結束之【後】
理工大学发生	理工大學【發】生
才算是真正的	【才】算是真正的
我们的爱过了	我們的愛過【了】
对此发表评论	對此【發】【表】評論
当他不再爱你	【當】他不再愛你
当地时间周四	【當】地時間【周】四
帅呆了帅呆了	帥呆【了】帥呆【了】
只求曾经拥有	【只】求曾經擁有
分布式计算机	分【佈】式計算機
只是普通朋友	【只】是普通朋友
走出我的世界	走【出】我的世界
给你发短信了	給你【發】短信【了】
改变了他们的	改變【了】他們的
十几年过去了	十【幾】年過去【了】
克里米亚战争	【克】【里】米亞戰爭
自欺欺人罢了	自欺欺人罷【了】
高脂蛋白血症	高脂蛋白血【症】
网络游戏平台	網絡【遊】戲平【臺】
实施经济制裁	實施經濟【制】裁
作者共同所有	作者共【同】所有
历史唯心主义	【歷】史唯心主義
国民党发言人	國民【黨】【發】言人
没有解决不了	沒有解決不【了】
网络休闲游戏	網絡休閑【遊】戲
给我打电话了	給我打電話【了】
学校卫生标准	學校衛生標【準】
保持良好关系	保持良好關【係】
一种与众不同	一【種】與眾不【同】
醒来发现自己	醒來【發】現自己
集团有关人士	集【團】有關人士
吸引了很多人	吸引【了】很多人
监督控制系统	監督控【制】【係】統
无法回到从前	無法【回】到從前
依法作出上述	依法作【出】上述
我会给你幸福	我會給你【幸】福
同母异父兄弟	【同】母異父兄弟
发展债券市场	【發】展債券市場
做出什么样的	做【出】什麼樣的
民主党候选人	民主【黨】候選人
发动侵略战争	【發】動侵略戰爭
昨天发布消息	昨天【發】【佈】消息
第一次见到了	第一次見到【了】
很快就结束了	很快就結束【了】
四轮驱动系统	四輪驅動【係】統
勇敢地站出来	勇敢地站【出】來
代表兄弟姐妹	代【表】兄弟姐妹
只要我们的心	【只】要我們的心
比赛最后阶段	比賽最【後】階段
真是太高兴了	真是太高興【了】
在一千年以后	在一【千】年以【後】
只有他们自己	【只】有他們自己
知道我是谁了	知道我是誰【了】
却得不到回报	卻得不到【回】報
被调查者表示	被調查者【表】示
你会发现原来	你會【發】現原來
了解更多新闻	【了】解更多新聞
当天在巴格达	【當】天在巴格達
本次发行数量	本次【發】行數量
软件开发周期	軟件開【發】【周】期
一个星期之后	一個星期之【後】
发表文章指出	【發】【表】文章指【出】
升级所需经验	【升】級所需經驗
乌克兰核弹头	烏【克】蘭核彈頭
男朋友吵架了	男朋友吵架【了】
也不是很了解	也不是很【了】解
我回去的时候	我【回】去的時候
遇到什么挫折	遇到什麼挫【折】
早点回去睡觉	早點【回】去睡覺
在北京会见了	在北京會見【了】
我只是问一下	我【只】是問一下
身上我看到了	身上我看到【了】
表面安装技术	【表】【面】安裝技【術】
不过最后还是	不過最【後】還是
网络互联技术	網絡互聯技【術】
这种不负责任	這【種】不負責任
在野党民主党	在野【黨】民主【黨】
酒足饭饱之后	酒足飯飽之【後】
新的会计准则	新的會計【準】則
成为美国历史	成爲美國【歷】史
出租车公司的	【出】租車公司的
松花江哈尔滨	【鬆】花江哈爾濱
我等着你回来	我等著你【回】來
慢慢就习惯了	慢慢就習慣【了】
复方甘草合剂	【復】方甘草合劑
横向经济联合	橫【向】經濟聯合
忘了我但是她	忘【了】我但是她
我只爱我老婆	我【只】愛我老婆
汽车产品召回	汽車產品召【回】
千万不要忘了	【千】【萬】不要忘【了】
不好意思刚才	不好意思剛【才】
我有什么关系	我有什麼關【係】
把我吓了一跳	把我嚇【了】一跳
北京市气象台	北京市氣象【臺】
招生计划总数	招生計【劃】總數
只有我们自己	【只】有我們自己
公布获奖名单	公【佈】【獲】獎名單
社会民主党人	社會民主【黨】人
的历史教科书	的【歷】史教科書
靖国神社参拜	靖國神社【參】拜
中国联通彩铃	中國聯通【彩】鈴
成了众矢之的	成【了】眾矢之的
新学期开始了	新學期開始【了】
媒体访问控制	媒體訪問控【制】
一周年纪念日	一【周】年紀念日
才可以明白的	【才】可以明白的
可以找到幸福	可以找到【幸】福
成为了好朋友	成爲【了】好朋友
不共戴天之仇	不共戴天之【仇】
用惯了自己的	用慣【了】自己的
经历了无数次	經【歷】【了】無數次
不见如隔三秋	不見如隔三【秋】
这一天出生的	這一天【出】生的
截至当地时间	截至【當】地時間
发展对华关系	【發】展對華關【係】
在一个角落里	在一個角落【里】
通用操作系统	通用操作【係】統
我们无法控制	我們無法控【制】
和你开玩笑了	和你開玩笑【了】
有着截然不同	有著截然不【同】
丰富的想像力	【豐】富的想像力
明确表示反对	明確【表】示反對
指挥部了解到	指揮部【了】解到
空气质量周报	空氣質量【周】報
持不同政见者	持不【同】政見者
到底为了什么	到底爲【了】什麼
但据记者了解	但【據】記者【了】解
一种怎么样的	一【種】怎麼樣的
给他们提供了	給他們提供【了】
首都布达佩斯	首都【佈】達佩斯
整体上市计划	整體上市計【劃】
农田生态系统	農田生態【係】統
长成参天大树	長成【參】天大樹
经济数据公布	經濟數【據】公【佈】
工作怎么样了	工作怎麼樣【了】
日志分类管理	日【志】分類管理
第一次见面看	第一次見【面】看
到底做了什么	到底做【了】什麼
在伊拉克北部	在伊拉【克】北部
十几岁的时候	十【幾】歲的時候
你是哪里人呢	你是哪【里】人呢
提出严厉批评	提【出】嚴厲批評
组委会了解到	組委會【了】解到
忘得差不多了	忘得差不多【了】
当地时间周五	【當】地時間【周】五
在这里写东西	在這【里】寫東西
你今年多大了	你今年多大【了】
根据以上情况	根【據】以上情況
见我最后一面	見我最【後】一【面】
对生活充满了	對生活充滿【了】
无论春夏秋冬	無論春夏【秋】【冬】
踏遍千山万水	踏遍【千】山【萬】水
不管刮风下雨	不管【刮】風下雨
伊拉克内政部	伊拉【克】內政部
外面的世界是	外【面】的世界是
知道自己该干	知道自己該【幹】
我只要你记住	我【只】要你記住
路上注意安全	路上【注】意安全
发过来我看看	【發】過來我看看
为自己赢得了	爲自己贏得【了】
在这个圈子里	在這個圈子【里】
奥特兰克山脉	奧特蘭【克】山脈
爽快的答应了	爽快的答應【了】
只要自己喜欢	【只】要自己喜歡
发现自己还是	【發】現自己還是
走到哪里都是	走到哪【里】都是
是一件很幸福	是一件很【幸】福
我找到了一个	我找到【了】一個
不要轻易尝试	不要輕易【嘗】試
复方阿司匹林	【復】方阿司匹林
记者调查了解	記者調查【了】解
法律关系主体	法律關【係】主體
希尔斯布莱德	希爾斯【佈】萊德
每当夜深人静	每【當】夜深人靜
逻辑链路控制	邏輯【鏈】路控【制】
想起了小时候	想起【了】小時候
几乎一无所知	【幾】乎一無所知
你就不理我了	你就不理我【了】
开出的任意球	開【出】的任意球
并行处理技术	【並】行處理技【術】
有关领导表示	有關領導【表】示
备受各界关注	備受各界關【注】
回报爱一个人	【回】報愛一個人
上市公司规范	上市公司規【範】
并派出工作组	【並】派【出】工作組
但他们并没有	但他們【並】沒有
那我就放心了	那我就放心【了】
响当当的人物	響【當】【當】的人物
对华出口管制	對華【出】口管【制】
挂牌交易出售	掛牌交易【出】售
就是一见钟情	就是一見【鍾】情
回到属于我的	【回】到屬於我的
人对记者表示	人對記者【表】示
确定发行价格	確定【發】行價格
高中阶段获得	高中階段【獲】得
给自己留下了	給自己留下【了】
巴勒斯坦当局	巴勒斯坦【當】局
自己只是一个	自己【只】是一個
进行最后一次	進行最【後】一次
充满了无限的	充滿【了】無限的
近几个交易日	近【幾】個交易日
表现有目共睹	【表】現有目共睹
人情薄似秋云	人情薄似【秋】【雲】
不用我说了吧	不用我說【了】吧
成分的一致性	成分的一【致】性
向记者提供了	【向】記者提供【了】
那你早点回去	那你早點【回】去
最后一次相信	最【後】一次相信
那就不要说了	那就不要說【了】
当地时间上午	【當】地時間上午
不管走到哪里	不管走到哪【里】
哈萨克斯坦队	哈薩【克】斯坦隊
我现在要下了	我現在要下【了】
皮质醇增多症	皮質醇增多【症】
派出所报了案	派【出】所報【了】案
又过了一会儿	又過【了】一會兒
出于什么样的	【出】於什麼樣的
第二信号系统	第二信號【係】統
的生活充满了	的生活充滿【了】
没有迹象表明	沒有跡象【表】明
记者采访时曾	記者【採】訪時曾
旅游小姐大赛	旅【遊】小姐大賽
气象专家表示	氣象專家【表】示
爆发出热烈的	爆【發】【出】熱烈的
手机铃声制作	手機鈴聲【制】作
二冲程发动机	二【衝】程【發】動機
我爱你一万年	我愛你一【萬】年
白发苍苍的老	白【發】蒼蒼的老
回春如意胶囊	【回】春如意膠囊
给自己带来了	給自己帶來【了】
奥运会历史上	奧運會【歷】史上
完全发挥出来	完全【發】揮【出】來
慢慢地学会了	慢慢地學會【了】
自然通风系统	自然通風【係】統
回答中外记者	【回】答中外記者
在会议结束后	在會議結束【後】
没时间上网了	沒時間上網【了】
变得复杂起来	變得【復】雜起來
派出所教导员	派【出】所教導員
可以松一口气	可以【鬆】一口氣
大学毕业后的	大學畢業【後】的
核磁共振技术	核磁共振技【術】
很久没有联系	很久沒有聯【係】
这时你会发现	這時你會【發】現
怎么没有出去	怎麼沒有【出】去
面对形形色色	【面】對形形色色
那我怎么联系	那我怎麼聯【係】
一点也不了解	一點也不【了】解
技术设备进口	技【術】設備進口
八国集团峰会	八國集【團】峰會
一点都不夸张	一點都不【誇】張
夫妻不要忘了	夫妻不要忘【了】
自顶向下方法	自頂【向】下方法
新加坡金曲奖	新加坡金【曲】獎
温度控制标准	溫度控【制】標【準】
消息据美联社	消息【據】美聯社
开新闻发布会	開新聞【發】【佈】會
中方共同努力	中方共【同】努力
技术临床应用	技【術】臨床應用
网络游戏服务	網絡【遊】戲服務
来自中国台湾	來自中國【臺】灣
几个回合下来	【幾】個【回】合下來
为了这个目标	爲【了】這個目標
突然发生爆炸	突然【發】生爆炸
各打五十大板	各打五十大【板】
再也忍受不了	再也忍受不【了】
电中国国民党	電中國國民【黨】
在比赛结束后	在比賽結束【後】
一个小时之后	一個小時之【後】
历史上最成功	【歷】史上最成功
我突然想到了	我突然想到【了】
的第一个周末	的第一個【周】末
你有什么关系	你有什麼關【係】
往事历历在目	往事【歷】【歷】在目
征收反补贴税	【徵】收反補貼稅
广发证券借壳	廣【發】證券【借】殼
政府官员表示	政府官員【表】示
是第一次见面	是第一次見【面】
留给我的回忆	留給我的【回】憶
就这么结束了	就這麼結束【了】
第五代战斗机	第五代戰【鬭】機
真的好想回到	真的好想【回】到
半个小时之后	半個小時之【後】
玩什么游戏了	玩什麼【遊】戲【了】
我已经结婚了	我已經結婚【了】
当时并不知道	【當】時【並】不知道
一个鼻孔出气	一個鼻孔【出】氣
讨论了那么久	討論【了】那麼久
不由得想起了	不由得想起【了】
能控制自己的	能控【制】自己的
当地气象部门	【當】地氣象部門
只是我自己的	【只】是我自己的
来说只是一个	來說【只】是一個
只许州官放火	【只】許州官放火
别人不一样的	【別】人不一樣的
早已不知去向	早已不知去【向】
哭得稀里哗啦	哭得稀【里】嘩啦
好不容易才把	好不容易【才】把
参加国际比赛	【參】加國際比賽
向记者解释说	【向】記者解釋說
现任总统布什	現任總統【佈】什
纳斯达克中国	納斯達【克】中國
不要想太多了	不要想太多【了】
阿拉伯电视台	阿拉伯電視【臺】
更多精彩美图	更多精【彩】美圖
错误的时间里	錯誤的時間【里】
即期外汇市场	即期外【匯】市場
才明白为什么	【才】明白爲什麼
一种莫名其妙	一【種】莫名其妙
电脑出问题了	電腦【出】問題【了】
只有在这样的	【只】有在這樣的
为了我们的爱	爲【了】我們的愛
民主党领导人	民主【黨】領導人
我也要回家了	我也要【回】家【了】
承受范围之内	承受【範】圍之內
青瓦台总统府	青瓦【臺】總統府
突然冒出来的	突然冒【出】來的
坚持不下去了	堅持不下去【了】
垃圾处理系统	垃圾處理【係】統
由南向北行驶	由南【向】北行駛
灌溉水质标准	灌溉水質標【準】
参加冠军联赛	【參】加冠軍聯賽
需要付出代价	需要付【出】代價
忘不了你温柔	忘不【了】你溫柔
整天提心吊胆	整天提心【吊】膽
中小企业板的	中小企業【板】的
混合动力技术	混合動力技【術】
上面密密麻麻	上【面】密密麻麻
很久很久以后	很久很久以【後】
抓获涉案人员	抓【獲】涉案人員
宁静的夜空里	寧靜的夜空【里】
叫什么名字了	叫什麼名字【了】
不和你说了啊	不和你說【了】啊
心里七上八下	心【里】七上八下
忍不住笑出声	忍不住笑【出】聲
谁让我爱上了	誰讓我愛上【了】
共同声明起步	共【同】聲明起步
无意间发现了	無意間【發】現【了】
一直以为幸福	一直以爲【幸】福
希望你能幸福	希望你能【幸】福
海淀工商分局	海【澱】工商分局
带来了无尽的	帶來【了】無【盡】的
一年后的今天	一年【後】的今天
布拉迪斯拉发	【佈】拉迪斯拉【發】
派出所了解到	派【出】所【了】解到
明月别枝惊鹊	明月【別】枝驚鵲
只能忍气吞声	【只】能忍氣吞聲
纽约外汇市场	紐約外【匯】市場
提升中国公民	提【升】中國公民
我住在你心里	我住在你心【里】
造成致命一击	造成【致】命一擊
爱乐管弦乐团	愛樂管弦樂【團】
共和党参议员	共和【黨】【參】議員
采取实际行动	【採】取實際行動
或许只是一个	或許【只】是一個
发表声明指出	【發】【表】聲明指【出】
中国烟草在线	中國【煙】草在線
启动应急机制	啓動應急機【制】
城市规划标准	城市規【劃】標【準】
朋友一起出去	朋友一起【出】去
说不出的高兴	說不【出】的高興
第一时间出来	第一時間【出】來
今年参加高考	今年【參】加高考
看着镜子里的	看著鏡子【里】的
在我们的周围	在我們的【周】圍
发现这个世界	【發】現這個世界
当前中日关系	【當】前中日關【係】
命中率达到了	命中率達到【了】
没有必要为了	沒有必要爲【了】
但是最后还是	但是最【後】還是
养血生发胶囊	養血生【發】膠囊
的哈萨克斯坦	的哈薩【克】斯坦
一点点就够了	一點點就夠【了】
是不是发错了	是不是【發】錯【了】
实在没办法了	實在沒辦法【了】
这个时候出现	這個時候【出】現
标准输出文件	標【準】輸【出】文件
烟草花叶病毒	【煙】草花葉病毒
这是一种新的	這是一【種】新的
影视美术设计	影視美【術】設計
总统卡尔扎伊	總統卡爾【扎】伊
伏安特性曲线	伏安特性【曲】線
调频广播电台	調頻廣播電【臺】
数据加密算法	數【據】加密算法
海峡两岸旅游	海峽兩岸旅【遊】
什么时候回去	什麼時候【回】去
只要开心就好	【只】要開心就好
共同历史研究	共【同】【歷】史研究
虚拟操作系统	虛擬操作【係】統
我实在想不出	我實在想不【出】
危急存亡之秋	危急存亡之【秋】
两国关系不断	兩國關【係】不斷
飞越千山万水	飛越【千】山【萬】水
后经抢救无效	【後】經搶救無效
根据中国足协	根【據】中國足協
一个星期以后	一個星期以【後】
我很喜欢这种	我很喜歡這【種】
中国国家外汇	中國國家外【匯】
港台最受欢迎	港【臺】最受歡迎
我不知道别人	我不知道【別】人
扑克牌通缉令	撲【克】牌通緝令
我也不知道了	我也不知道【了】
的人士向记者	的人士【向】記者
运动技术学院	運動技【術】學院
多少年过去了	多少年過去【了】
男儿志在四方	男兒【志】在四方
向媒体通报了	【向】媒體通報【了】
事务管理制度	事務管理【制】度
的名字出现在	的名字【出】現在
克什米尔问题	【克】什米爾問題
再也抑制不住	再也抑【制】不住
在同一个时间	在【同】一個時間
制造工业部门	【制】造工業部門
虚拟的世界里	虛擬的世界【里】
奥运会做准备	奧運會做【準】備
这不是明摆着	這不是明【擺】著
我明天就回家	我明天就【回】家
台北寂寞部屋	【臺】北寂寞部屋
我找不到方向	我找不到方【向】
报名参加高考	報名【參】加高考
本周晚些时候	本【周】晚些時候
在随后进行的	在隨【後】進行的
面对生活中的	【面】對生活中的
最大光圈范围	最大光圈【範】圍
参议院多数党	【參】議院多數【黨】
电气设备标准	電氣設備標【準】
巴勒斯坦方面	巴勒斯坦方【面】
冻得瑟瑟发抖	凍得瑟瑟【發】抖
不过没有关系	不過沒有關【係】
在角落里哭泣	在角落【里】哭泣
人死不能复生	人死不能【復】生
无论刮风下雨	無論【刮】風下雨
胜过千言万语	勝過【千】言【萬】語
知道为了什么	知道爲【了】什麼
我忽然想起了	我忽然想起【了】
强制访问控制	強【制】訪問控【制】
回宿舍的路上	【回】宿【舍】的路上
我在这里等你	我在這【里】等你
我们有共同的	我們有共【同】的
上市公司回购	上市公司【回】購
回到了原来的	【回】到【了】原來的
一个幸福美满	一個【幸】福美滿
新闻发言人武	新聞【發】言人武
自己注意身体	自己【注】意身體
总统府发言人	總統府【發】言人
发生正面冲突	【發】生正【面】【衝】突
面向连接协议	【面】【向】連接協議
盎格鲁萨克逊	盎格魯薩【克】遜
一切烟消云散	一切【煙】消【雲】散
在这个季节里	在這個季節【里】
我国网络游戏	我國網絡【遊】戲
历史人文地理	【歷】史人文地理
单边行动计划	單邊行動計【劃】
表示强烈反对	【表】示強烈反對
我学会了珍惜	我學會【了】珍惜
只有一个原因	【只】有一個原因
发行股票方案	【發】行股票方案
忘不了忘不了	忘不【了】忘不【了】
你发的什么啊	你【發】的什麼啊
玩家密切关注	玩家密切關【注】
士兵在伊拉克	士兵在伊拉【克】
别问我为什么	【別】問我爲什麼
过着幸福快乐	過著【幸】福快樂
新闻发言人焦	新聞【發】言人焦
两岸关系朝着	兩岸關【係】朝著
只能听天由命	【只】能聽天由命
伊拉克战争和	伊拉【克】戰爭和
发现自己喜欢	【發】現自己喜歡
气得说不出话	氣得說不【出】話
最近几个月来	最近【幾】個月來
成为万众瞩目	成爲【萬】眾矚目
奥运会上获得	奧運會上【獲】得
工作人员编制	工作人員編【制】
也是一种乐趣	也是一【種】樂趣
我这里没有啊	我這【里】沒有啊
为了一个女人	爲【了】一個女人
共和党众议员	共和【黨】眾議員
嘴里念念有词	嘴【里】念念有詞
恢复六方会谈	恢【復】六方會談
电视台报道称	電視【臺】報道稱
的态度去面对	的態度去【面】對
也许只是一个	也許【只】是一個
地图信息系统	地圖信息【係】統
女人心海底针	女人心海底【針】
这一段时间里	這一段時間【里】
把自己当回事	把自己【當】【回】事
说不出的难受	說不【出】的難受
漂亮的小姑娘	漂亮的小姑【娘】
已经泪流满面	已經淚流滿【面】
考虑范围之内	考慮【範】圍之內
有关突发事件	有關突【發】事件
在人际关系上	在人際關【係】上
只是一厢情愿	【只】是一廂情願
只是因为我们	【只】是因爲我們
民族网络游戏	民族網絡【遊】戲
在你面前流泪	在你【面】前流淚
提出强烈抗议	提【出】強烈抗議
过了一个小时	過【了】一個小時
我明天就走了	我明天就走【了】
怎么样才算是	怎麼樣【才】算是
我找到了自己	我找到【了】自己
土地信息系统	土地信息【係】統
在当地引起了	在【當】地引起【了】
很幸福很幸福	很【幸】福很【幸】福
我该如何面对	我該如何【面】對
就是为了寻找	就是爲【了】尋找
几乎每一个人	【幾】乎每一個人
让玩家在游戏	讓玩家在【遊】戲
中国人寿集团	中國人壽集【團】
不要开玩笑了	不要開玩笑【了】
我已经知足了	我已經知足【了】
对此表示赞同	對此【表】示贊【同】
复杂数据类型	【復】雜數【據】類型
固定式升降机	固定式【升】降機
千万不要告诉	【千】【萬】不要告訴
期房销售面积	期房銷售【面】積
已经记不清了	已經記不清【了】
许多年过去了	許多年過去【了】
纵有千种风情	縱有【千】【種】風情
一起出去吃饭	一起【出】去吃飯
真是欲哭无泪	真是【欲】哭無淚
你会发现其实	你會【發】現其實
应该差不多了	應該差不多【了】
没有勾心斗角	沒有勾心【鬭】角
永远在我心里	永遠在我心【里】
俄罗斯代表团	俄羅斯代【表】【團】
财政大臣布朗	財政大臣【佈】朗
在公共厕所里	在公共廁所【里】
只能打两个字	【只】能打兩個字
煤矿发生特大	煤礦【發】生特大
中国党和政府	中國【黨】和政府
这是自动回复	這是自動【回】【復】
期货公司应当	期貨公司應【當】
没有注意到我	沒有【注】意到我
再这样下去了	再這樣下去【了】
电中央气象台	電中央氣象【臺】
坐在沙发上的	坐在沙【發】上的
中心发射升空	中心【發】射【升】空
又有什么不同	又有什麼不【同】
雷霆万钧之势	雷霆【萬】鈞之勢
只是为了自己	【只】是爲【了】自己
千万不要随便	【千】【萬】不要隨便
发信息给我啊	【發】信息給我啊
早就准备好了	早就【準】備好【了】
办公信息系统	辦公信息【係】統
不应该发生的	不應該【發】生的
也是一种选择	也是一【種】選擇
的时候出现在	的時候【出】現在
爱你我不后悔	愛你我不【後】悔
草原生态系统	草原生態【係】統
只在一念之间	【只】在一念之間
巴基斯坦方面	巴基斯坦方【面】
那是怎么回事	那是怎麼【回】事
来这里干什么	來這【里】【幹】什麼
双方发生争执	雙方【發】生爭執
有些出乎意料	有些【出】乎意料
发生了一件事	【發】生【了】一件事
先发制人打击	先【發】【制】人打擊
我当时就觉得	我【當】時就覺得
似乎已经成了	似乎已經成【了】
他们才是真正	他們【才】是真正
永远停在那里	永遠停在那【里】
早已不复存在	早已不【復】存在
千不该万不该	【千】不該【萬】不該
就此发表评论	就此【發】【表】評論
真正了解自己	真正【了】解自己
同中国的关系	【同】中國的關【係】
复方鱼腥草片	【復】方魚腥草片
不小心碰到了	不小心碰到【了】
学得怎么样了	學得怎麼樣【了】
央行数据显示	央行數【據】顯示
只是一个过程	【只】是一個過程
参加普通高考	【參】加普通高考
工业发展基金	工業【發】展基金
周围神经系统	【周】圍神經【係】統
布什政府正在	【佈】什政府正在
一时多少豪杰	一時多少豪【傑】
总有一种约束	總有一【種】約束
就是那么回事	就是那麼【回】事
直到最后一刻	直到最【後】一刻
已经开始准备	已經開始【準】備
农业信息系统	農業信息【係】統
喘不过气来了	喘不過氣來【了】
似乎感觉到了	似乎感覺到【了】
也不会回来了	也不會【回】來【了】
只有一个人的	【只】有一個人的
我们最后一次	我們最【後】一次
散发出淡淡的	散【發】【出】淡淡的
终日以泪洗面	終日以淚洗【面】
我明白了什么	我明白【了】什麼
我明白了一个	我明白【了】一個
采取一致行动	【採】取一【致】行動
施密特触发器	施密特觸【發】器
出租车停车场	【出】租車停車場
作出最后决定	作【出】最【後】決定
弹道导弹防御	彈道導彈防【御】
当天晚些时候	【當】天晚些時候
半决赛首回合	半決賽首【回】合
工作程序标准	工作程序標【準】
现在在那里呢	現在在那【里】呢
已经走到尽头	已經走到【盡】頭
心里已经有了	心【里】已經有【了】
受不了的就是	受不【了】的就是
拒绝接受采访	拒絕接受【採】訪
深思熟虑之后	深思熟慮之【後】
只是随便说说	【只】是隨便說說
我们共同走过	我們共【同】走過
在伊拉克首都	在伊拉【克】首都
哪怕只是一个	哪怕【只】是一個
究竟怎么回事	究竟怎麼【回】事
走出患得患失	走【出】患得患失
不愉快的经历	不愉快的經【歷】
气象台发布了	氣象【臺】【發】【佈】【了】
我的幸福时光	我的【幸】福時光
我已经说过了	我已經說過【了】
都不放在眼里	都不放在眼【里】
赶到案发现场	趕到案【發】現場
发自内心深处	【發】自內心深處
也是一种美德	也是一【種】美德
有时间再联系	有時間再聯【係】
不应该出现在	不應該【出】現在
有种说不出来	有【種】說不【出】來
必须努力学习	必【須】努力學習
签署了一系列	【籖】署【了】一【係】列
只有一个目标	【只】有一個目標
发思古之幽情	【發】思古之幽情
一向被认为是	一【向】被認爲是
只是为了满足	【只】是爲【了】滿足
世界杯开始了	世界杯開始【了】
累得气喘吁吁	纍得氣喘【籲】【籲】
标准编制说明	標【準】編【制】說明
选择这种方式	選擇這【種】方式
广发证券总裁	廣【發】證券總裁
别人的同时也	【別】人的【同】時也
究竟是怎么了	究竟是怎麼【了】
新华社记者周	新華社記者【周】
除了吃饭睡觉	除【了】吃飯睡覺
改善两岸关系	改善兩岸關【係】
落实共同声明	落實共【同】聲明
并非没有可能	【並】非沒有可能
将要发生什么	將要【發】生什麼
付出我的全部	付【出】我的全部
那就不打扰了	那就不打擾【了】
她们在哪里呀	她們在哪【里】呀
实行单向收费	實行單【向】收費
费尽千辛万苦	費【盡】【千】辛【萬】苦
增加产品品种	增加產品品【種】
心里说不出的	心【里】說不【出】的
我要睡觉去了	我要睡覺去【了】
知道我在这里	知道我在這【里】
亲者痛仇者快	親者痛【仇】者快
一直没有发现	一直沒有【發】現
理由只有一个	理由【只】有一個
玩家进入游戏	玩家進入【遊】戲
热水供应系统	熱水供應【係】統
以后该怎么办	以【後】該怎麼辦
也许只是因为	也許【只】是因爲
渐渐喜欢上了	漸漸喜歡上【了】
可能只有一个	可能【只】有一個
给了我很多的	給【了】我很多的
世间总有一种	世間總有一【種】
奥特兰克山谷	奧特蘭【克】山【谷】
流动注射分析	流動【注】射分析
万事达卡国际	【萬】事達卡國際
手术非常成功	手【術】非常成功
没有勇气面对	沒有勇氣【面】對
着实吓了一跳	著實嚇【了】一跳
想不出更好的	想不【出】更好的
标准输入文件	標【準】輸入文件
智能决策系统	智能決策【係】統
气吞万里如虎	氣吞【萬】【里】如虎
花了那么多钱	花【了】那麼多錢
我有男朋友了	我有男朋友【了】
认真填写意向	認真填寫意【向】
第一次出远门	第一次【出】遠門
梦后楼台高锁	夢【後】樓【臺】高鎖
最近忙什么了	最近忙什麼【了】
并不会因此而	【並】不會因此而
并不代表什么	【並】不代【表】什麼
我和你写不出	我和你寫不【出】
神经精神症状	神經精神【症】狀
怎么了生气了	怎麼【了】生氣【了】
公布股改方案	公【佈】股改方案
表现相当不错	【表】現相【當】不錯
一步一步走出	一步一步走【出】
系统使用型号	【係】統使用型號
发现自己已深	【發】現自己已深
客户身份识别	客戶身份識【別】
远隔千山万水	遠隔【千】山【萬】水
前怕狼后怕虎	前怕狼【後】怕虎
已经无法挽回	已經無法【挽】【回】
也对记者表示	也對記者【表】示
从哈萨克斯坦	從哈薩【克】斯坦
永无出头之日	永無【出】頭之日
已经无所谓了	已經無所謂【了】
经历了无数的	經【歷】【了】無數的
一时说不出话	一時說不【出】話
网络游戏研发	網絡【遊】戲研【發】
回避这个问题	【回】避這個問題
后悔有什么用	【後】悔有什麼用
斯里兰卡总统	斯【里】蘭卡總統
就是开不了口	就是開不【了】口
回到现实中来	【回】到現實中來
沙发上睡着了	沙【發】上睡著【了】
关起来只留下	關起來【只】留下
的爱只有一次	的愛【只】有一次
要付出的代价	要付【出】的代價
不过现在好了	不過現在好【了】
进入了倒计时	進入【了】倒計時
我看到了很多	我看到【了】很多
我刚才出去了	我剛【才】【出】去【了】
怎么不说话了	怎麼不說話【了】
注重书本知识	【注】重書本知識
小天后蔡依林	小天【後】蔡依林
在伊拉克南部	在伊拉【克】南部
自民党干事长	自民【黨】【幹】事長
什么样的表情	什麼樣的【表】情
伊拉克电视台	伊拉【克】電視【臺】
发动恐怖袭击	【發】動恐怖襲擊
一切都是轮回	一切都是輪【回】
一起玩游戏网	一起玩【遊】戲網
海通证券借壳	海通證券【借】殼
不要说废话了	不要說廢話【了】
两岸共同市场	兩岸共【同】市場
医疗保健制度	醫療保健【制】度
纽约尼克斯队	紐約尼【克】斯隊
焦虑性神经症	焦慮性神經【症】
爱情也是一种	愛情也是一【種】
我就喜欢上了	我就喜歡上【了】
早已荡然无存	早已【蕩】然無存
你在干什么了	你在【幹】什麼【了】
联通彩铃业务	聯通【彩】鈴業務
其他网络游戏	其他網絡【遊】戲
在大家的面前	在大家的【面】前
只能躺在床上	【只】能躺在床上
电子出版系统	電子【出】版【係】統
有着说不出的	有著說不【出】的
任何联系方式	任何聯【係】方式
我学会了放弃	我學會【了】放棄
甘露醇注射液	甘露醇【注】射液
那里做什么呀	那【里】做什麼呀
这并不是一件	這【並】不是一件
散发着诱人的	散【發】著誘人的
有时间上网了	有時間上網【了】
辐射采暖系统	輻射【採】暖【係】統
我都想死你了	我都想死你【了】
之后我才发现	之【後】我【才】【發】現
发现自己其实	【發】現自己其實
熟女欲望日记	熟女【欲】望日記
也是一种伤害	也是一【種】傷害
我们一起出去	我們一起【出】去
美国布什政府	美國【佈】什政府
当时也不知道	【當】時也不知道
这段时间发生	這段時間【發】生
点击进入网游	點擊進入網【遊】
这件事情发生	這件事情【發】生
习惯了就好了	習慣【了】就好【了】
微距对焦范围	微距對焦【範】圍
恐怖袭击发生	恐怖襲擊【發】生
据新华社专电	【據】新華社專電
页面描述语言	頁【面】描述語言
考上了研究生	考上【了】研究生
毕竟只是一个	畢竟【只】是一個
应用开发工具	應用開【發】工具
再也受不了了	再也受不【了】【了】
一种不可思议	一【種】不可思議
本科艺术院校	本科藝【術】院校
男女朋友关系	男女朋友關【係】
第一时间出现	第一時間【出】現
强烈的占有欲	強烈的【佔】有【欲】
广大香港同胞	廣大香港【同】胞
主帅埃里克森	主帥埃【里】【克】森
解郁安神颗粒	解【鬱】安神顆粒
汽车凹陷修复	汽車凹陷修【復】
辛苦了一辈子	辛苦【了】一輩子
我已经尽力了	我已經【盡】力【了】
成了无话不谈	成【了】無話不談
然后我们一起	然【後】我們一起
多处理机系统	多處理機【係】統
我愿意为了你	我願意爲【了】你
我才明白原来	我【才】明白原來
点击进入精彩	點擊進入精【彩】
走在回家的路	走在【回】家的路
领导人卡扎菲	領導人卡【扎】菲
自己心里明白	自己心【里】明白
电话里的声音	電話【里】的聲音
都已经习惯了	都已經習慣【了】
当天发表声明	【當】天【發】【表】聲明
向新华社记者	【向】新華社記者
气象台了解到	氣象【臺】【了】解到
气得浑身发抖	氣得渾身【發】抖
我不后悔我曾	我不【後】悔我曾
只有爱与不爱	【只】有愛與不愛
仅仅只是为了	僅僅【只】是爲【了】
快回来快回来	快【回】來快【回】來
因为有一种爱	因爲有一【種】愛
好久没见了哦	好久沒見【了】哦
游戏开发人员	【遊】戲開【發】人員
联合信息平台	聯合信息平【臺】
控制着自己的	控【制】著自己的
我去洗澡去了	我去洗澡去【了】
经历过的事情	經【歷】過的事情
中国队派出了	中國隊派【出】【了】
早上起来发现	早上起來【發】現
面无表情地说	【面】無【表】情地說
区别轻重缓急	區【別】輕重緩急
我学会了沉默	我學會【了】沉默
分手说不出来	分手說不【出】來
几乎异口同声	【幾】乎異口【同】聲
塞纳里奥议会	塞納【里】奧議會
心有余力不足	心有【餘】力不足
眼里闪过一丝	眼【里】閃過一絲
的时间并不多	的時間【並】不多
法制日报报道	法【制】日報報道
中日两国关系	中日兩國關【係】
不能控制他人	不能控【制】他人
奥兰多魔术队	奧蘭多魔【術】隊
千万不要放弃	【千】【萬】不要放棄
犯罪团伙成员	犯罪【團】【夥】成員
参加六方会谈	【參】加六方會談
回家做什么啊	【回】家做什麼啊
我会尽快回复	我會【盡】快【回】【復】
行为付出代价	行爲付【出】代價
是他最后一次	是他最【後】一次
向战略投资者	【向】戰略投資者
亚历山大帝国	亞【歷】山大帝國
后才知道什么	【後】【才】知道什麼
最向往的地方	最【向】往的地方
等你是种美丽	等你是【種】美麗
从口袋里摸出	從口袋【里】摸【出】
质量利用系数	質量利用【係】數
只有一个感觉	【只】有一個感覺
发生在她身上	【發】生在她身上
特别提醒考生	特【別】提醒考生
只是真的爱你	【只】是真的愛你
公安局了解到	公安局【了】解到
发短信打电话	【發】短信打電話
标准工作制度	標【準】工作【制】度
获利回吐压力	【獲】利【回】吐壓力
快乐西游专区	快樂西【遊】專區
放在心里世界	放在心【里】世界
这时我才知道	這時我【才】知道
永远不会出现	永遠不會【出】現
把我放在眼里	把我放在眼【里】
发行的新专辑	【發】行的新專輯
因为他增进了	因爲他增進【了】
眼睛里闪烁着	眼睛【里】閃爍著
能坚持到最后	能堅持到最【後】
不在乎别人的	不在乎【別】人的
终于发现自己	終於【發】現自己
必须做的事情	必【須】做的事情
背叛了自己的	背叛【了】自己的
只不过是一场	【只】不過是一場
第一次尝到了	第一次【嘗】到【了】
真的是很幸福	真的是很【幸】福
两年后的今天	兩年【後】的今天
我们该出发了	我們該【出】【發】【了】
二进制的一位	二進【制】的一位
你不信就算了	你不信就算【了】
租了一间房子	租【了】一間房子
国美电器集团	國美電器集【團】
共同战略利益	共【同】戰略利益
这样日复一日	這樣日【復】一日
先小人后君子	先小人【後】君子
只是生命中的	【只】是生命中的
还是一无所获	還是一無所【獲】
美好的日子里	美好的日子【里】
但是时间长了	但是時間長【了】
你找男朋友了	你找男朋友【了】
在伊拉克境内	在伊拉【克】境內
后来怎么样了	【後】來怎麼樣【了】
沈阳市教育局	【瀋】陽市教育局
质量保证标准	質量保證標【準】
长长叹了口气	長長嘆【了】口氣
石油输出国家	石油輸【出】國家
德里克安德森	德【里】【克】安德森
在那里还好吗	在那【里】還好嗎
传统园林建筑	傳統園林建【築】
联想集团高级	聯想集【團】高級
汽车制造厂商	汽車【制】造廠商
那里做什么啊	那【里】做什麼啊
云知道你是谁	【雲】知道你是誰
依然历历在目	依然【歷】【歷】在目
迷恋网络游戏	迷戀網絡【遊】戲
一种说不出来	一【種】說不【出】來
了温家宝总理	【了】溫家寶總理
枪击事件发生	槍擊事件【發】生
在虚拟世界里	在虛擬世界【里】
航空研究开发	航空研究開【發】
轻伤鉴定标准	輕傷鑒定標【準】
斯蒂芬马布里	斯蒂芬馬【佈】【里】
液压控制装置	液壓控【制】裝置
回忆也是一种	【回】憶也是一【種】
非农就业数据	非農就業數【據】
得不到的才是	得不到的【才】是
哈里发体育场	哈【里】【發】體育場
也是一种缘分	也是一【種】緣分
不是为了抓紧	不是爲【了】抓緊
职业学校建筑	職業學校建【築】
不想面对现实	不想【面】對現實
记者几经周折	記者【幾】經【周】【折】
觉得很没面子	覺得很沒【面】子
也是一种习惯	也是一【種】習慣
软件生存周期	軟件生存【周】期
的时候我哭了	的時候我哭【了】
对面没有了你	對【面】沒有【了】你
埃博拉出血热	埃博拉【出】血熱
这样反反复复	這樣反反【復】【復】
据犯罪嫌疑人	【據】犯罪嫌疑人
系统执行程序	【係】統執行程序
好想回到过去	好想【回】到過去
的时候看见了	的時候看見【了】
连续语音识别	連續語音識【別】
只是一直没有	【只】是一直沒有
进入了白热化	進入【了】白熱化
制造资源规划	【制】造資源規【劃】
也要注意身体	也要【注】意身體
喜欢的人面前	喜歡的人【面】前
系统资源管理	【係】統資源管理
只有一个愿望	【只】有一個願望
记者联系上了	記者聯【係】上【了】
我忘记了呼吸	我忘記【了】呼吸
烧得面目全非	燒得【面】目全非
我很想为了你	我很想爲【了】你
周围所有的人	【周】圍所有的人
只是一场游戏	【只】是一場【遊】戲
伊拉克境内的	伊拉【克】境內的
伊拉克国内的	伊拉【克】國內的
题材网络游戏	題材網絡【遊】戲
最后一片叶子	最【後】一片葉子
樯橹灰飞烟灭	檣櫓灰飛【煙】滅
一次同学聚会	一次【同】學聚會
皇家爱乐乐团	皇家愛樂樂【團】
致密结缔组织	【致】密結締組織
寒冷的冬天里	寒冷的【冬】天【里】
文字表达出来	文字【表】達【出】來
盐酸克仑特罗	鹽酸【克】【侖】特羅
万里长城万里	【萬】【里】長城【萬】【里】
我不喜欢这种	我不喜歡這【種】
深深打动了我	深深打動【了】我
我送你回去吧	我送你【回】去吧
沉迷系统实名	沉迷【係】統實名
新浪军事论坛	新浪軍事論【壇】
警方调查发现	警方調查【發】現
因为他强化了	因爲他強化【了】
暗视野显微镜	【暗】視野顯微鏡
逐步回归分析	逐步【回】歸分析
就已经结束了	就已經結束【了】
他已经习惯了	他已經習慣【了】
渐渐暗了下来	漸漸【暗】【了】下來
在比赛中发挥	在比賽中【發】揮
也许你会发现	也許你會【發】現
刚出生的时候	剛【出】生的時候
丑不是你的错	【醜】不是你的錯
我现在知道了	我現在知道【了】
没有来上网了	沒有來上網【了】
消失在黑暗中	消失在黑【暗】中
调查人员发现	調查人員【發】現
我第一次发现	我第一次【發】現
有话说不出来	有話說不【出】來
伏尔加船夫曲	伏爾加船夫【曲】
尽力做到最好	【盡】力做到最好
填志愿填志愿	填【志】願填【志】願
后才知道原来	【後】【才】知道原來
这是一种多么	這是一【種】多麼
已经喜欢上了	已經喜歡上【了】
综合测试系统	綜合測試【係】統
再也睡不着了	再也睡不著【了】
过去的日子里	過去的日子【里】
在那里怎么样	在那【里】怎麼樣
面对心爱的人	【面】對心愛的人
早已经习惯了	早已經習慣【了】
你是干吗的啊	你是【幹】嗎的啊
等了好久好久	等【了】好久好久
我看到了什么	我看到【了】什麼
推动中美关系	推動中美關【係】
从此以后我们	從此以【後】我們
动态规划算法	動態規【劃】算法
出租汽车运价	【出】租汽車運價
埃尔顿布兰德	埃爾頓【佈】蘭德
以后还是朋友	以【後】還是朋友
向媒体公布了	【向】媒體公【佈】【了】
我有事出去了	我有事【出】去【了】
生命最后一刻	生命最【後】一刻
不方便就算了	不方便就算【了】
再也无法控制	再也無法控【制】
忧郁的星期天	憂【鬱】的星期天
可是最后还是	可是最【後】還是
灿烂的日子里	燦爛的日子【里】
学会了如何去	學會【了】如何去
在未来几天内	在未來【幾】天內
被我们遗忘了	被我們遺忘【了】
斯里巴加湾市	斯【里】巴加灣市
永远只是一个	永遠【只】是一個
什么都不是了	什麼都不是【了】
只愿面朝大海	【只】願【面】朝大海
全球家电论坛	全球家電論【壇】
你会发现生活	你會【發】現生活
高级官员表示	高級官員【表】示
有表决权股份	有【表】決權股份
北京商场打折	北京商場打【折】
导致中国学生	導【致】中國學生
省公安厅获悉	省公安廳【獲】悉
定义数据类型	定義數【據】類型
不管以后的路	不管以【後】的路
要多注意身体	要多【注】意身體
善后工作正在	善【後】工作正在
让你们失望了	讓你們失望【了】
没有发送成功	沒有【發】送成功
只是希望你能	【只】是希望你能
在所有人面前	在所有人【面】前
开始懂了快乐	開始懂【了】快樂
昨天晚上做了	昨天晚上做【了】
未尝不是好事	未【嘗】不是好事
据北京青年报	【據】北京青年報
发工资的时候	【發】工資的時候
维修标准规范	維修標【準】規【範】
管理方法标准	管理方法標【準】
拒人千里之外	拒人【千】【里】之外
国内平板电视	國內平【板】電視
是不是生气了	是不是生氣【了】
注定要失去的	【注】定要失去的
高中同学聚会	高中【同】學聚會
白发谁家翁媪	白【發】誰家翁媼
气候变化方面	氣候變化方【面】
重视对华关系	重視對華關【係】
紧紧地抓住了	緊緊地抓住【了】
忘得干干净净	忘得【幹】【幹】凈凈
系统与处理器	【係】統與處理器
为了打发时间	爲【了】打【發】時間
已经说不出话	已經說不【出】話
女孩发现自己	女孩【發】現自己
还是没有出现	還是沒有【出】現
解决不了任何	解決不【了】任何
穿琥宁注射液	穿琥寧【注】射液
看到了没有啊	看到【了】沒有啊
我们只是朋友	我們【只】是朋友
体育精彩图片	體育精【彩】圖片
两个人的回忆	兩個人的【回】憶
红旗漫卷西风	紅旗漫【捲】西風
违规强制拆迁	違規強【制】拆遷
要求考生根据	要求考生根【據】
的心情很复杂	的心情很【復】雜
华盛顿奇才队	華盛頓奇【才】隊
被媒体曝光后	被媒體曝光【後】
多注意身体啊	多【注】意身體啊
我们多么幸福	我們多麼【幸】福
为什么别人的	爲什麼【別】人的
最后的一句话	最【後】的一句話
这个决定别人	這個決定【別】人
这个消息之后	這個消息之【後】
活着不是为了	活著不是爲【了】
是什么样子了	是什麼樣子【了】
每当我想起你	每【當】我想起你
一种似曾相识	一【種】似曾相識
只是简简单单	【只】是簡簡單單
你还不回家啊	你還不【回】家啊
六方会谈团长	六方會談【團】長
只要有一点点	【只】要有一點點
表示强烈谴责	【表】示強烈譴責
过了一个世纪	過【了】一個世紀
据中国证券报	【據】中國證券報
然后闭上眼睛	然【後】閉上眼睛
城市排水系统	城市排水【係】統
如堕五里雾中	如墮五【里】霧中
斯里兰卡军方	斯【里】蘭卡軍方
面对这么多的	【面】對這麼多的
何尝不是一个	何【嘗】不是一個
很多年过去了	很多年過去【了】
新的开始别让	新的開始【別】讓
刻在我的心里	刻在我的心【里】
走出你的世界	走【出】你的世界
我忘记了快乐	我忘記【了】快樂
只是我的一个	【只】是我的一個
无法忍受这种	無法忍受這【種】
为什么这几天	爲什麼這【幾】天
出淤泥而不染	【出】淤泥而不染
看到你上网了	看到你上網【了】
只是受了点伤	【只】是受【了】點傷
生活得很幸福	生活得很【幸】福
卡洛斯布泽尔	卡洛斯【佈】澤爾
我给你发信息	我給你【發】信息
不论走到哪里	不論走到哪【里】
的回答很简单	的【回】答很簡單
别人不知道的	【別】人不知道的
医生检查发现	醫生檢查【發】現
现在在哪里呀	現在在哪【里】呀
第一次感到了	第一次感到【了】
为真理而斗争	爲真理而【鬭】爭
有种似曾相识	有【種】似曾相識
的精神世界里	的精神世界【里】
不幸中之大幸	不【幸】中之大【幸】
发言人在接受	【發】言人在接受
醉里且贪欢笑	醉【里】且貪歡笑
的要求太高了	的要求太高【了】
终端控制系统	終端控【制】【係】統
同样也是一种	【同】樣也是一【種】
内蒙古东部的	內【蒙】古東部的
据美联社报道	【據】美聯社報道
伊拉克目前的	伊拉【克】目前的
忧郁的一片天	憂【鬱】的一片天
软件开发模型	軟件開【發】模型
网络游戏领域	網絡【遊】戲領域
最后一个项目	最【後】一個項目
参加同学聚会	【參】加【同】學聚會
永远快乐幸福	永遠快樂【幸】福
那么长时间了	那麼長時間【了】
发生恐怖袭击	【發】生恐怖襲擊
阅读更多精彩	閱讀更多精【彩】
国际政治舞台	國際政治舞【臺】
周围空气温度	【周】圍空氣溫度
化学发光分析	化學【發】光分析
发现自己一直	【發】現自己一直
我在玩游戏呢	我在玩【遊】戲呢
程序开发计划	程序開【發】計【劃】
我只是想让你	我【只】是想讓你
资金占用问题	資金【佔】用問題
发短信的时候	【發】短信的時候
交通恢复正常	交通恢【復】正常
出现的那个人	【出】現的那個人
说不出为什么	說不【出】爲什麼
回到从前那个	【回】到從前那個
就要付出代价	就要付【出】代價
什么都不管了	什麼都不管【了】
我给你发过去	我給你【發】過去
忙得晕头转向	忙得暈頭轉【向】
这时千万不要	這時【千】【萬】不要
好几天都没有	好【幾】天都沒有
我心里很难受	我心【里】很難受
他对记者表示	他對記者【表】示
他给了我一个	他給【了】我一個
法制计量组织	法【制】計量組織
不论发生什么	不論【發】生什麼
只是为了一个	【只】是爲【了】一個
高层对话机制	高層對話機【制】
属于我的幸福	屬於我的【幸】福
在比赛中表现	在比賽中【表】現
后才知道自己	【後】【才】知道自己
表观分布容积	【表】觀分【佈】容積
人口信息系统	人口信息【係】統
参加超级女声	【參】加超級女聲
发生任何事情	【發】生任何事情
更多精彩动画	更多精【彩】動畫
水平定向钻机	水平定【向】鑽機
广播公司采访	廣播公司【採】訪
后才知道后悔	【後】【才】知道【後】悔
就这么决定了	就這麼決定【了】
做了什么事情	做【了】什麼事情
在那段日子里	在那段日子【里】
并发操作系统	【並】【發】操作【係】統
对我来说并不	對我來說【並】不
仍然历历在目	仍然【歷】【歷】在目
我在下面等你	我在下【面】等你
只是点了点头	【只】是點【了】點頭
最后一点力气	最【後】一點力氣
在这些日子里	在這些日子【里】
未发生有责任	未【發】生有責任
抑制过度投机	抑【制】過度投機
不愿意让别人	不願意讓【別】人
眼神里充满了	眼神【里】充滿【了】
作出这个决定	作【出】這個決定
真有点舍不得	真有點【舍】不得
不敢面对现实	不敢【面】對現實
采取报复行动	【採】取報【復】行動
费城交响乐团	費城交響樂【團】
演唱会结束后	演唱會結束【後】
在这样的夜里	在這樣的夜【里】
据台湾联合报	【據】【臺】灣聯合報
克莱斯勒品牌	【克】萊斯勒品牌
企业系统规划	企業【係】統規【劃】
强制保险费率	強【制】保險費率
的时间太少了	的時間太少【了】
对数正态分布	對數正態分【佈】
沿海发展战略	沿海【發】展戰略
就站在你的面	就站在你的【面】
我回去睡觉了	我【回】去睡覺【了】
一秒钟的时间	一秒【鍾】的時間
参选台北市长	【參】選【臺】北市長
连续控制系统	連續控【制】【係】統
大家不约而同	大家不約而【同】
直接利益冲突	直接利益【衝】突
当着全班同学	【當】著全班【同】學
只是个恶作剧	【只】是個【惡】作劇
哪怕只有一个	哪怕【只】有一個
我不和你聊了	我不和你聊【了】
才是真正的爱	【才】是真正的愛
过两天就好了	過兩天就好【了】
几天后的一个	【幾】天【後】的一個
资讯分析系统	資訊分析【係】統
你又在玩游戏	你又在玩【遊】戲
广大游戏玩家	廣大【遊】戲玩家
电脑有问题了	電腦有問題【了】
还没有回答我	還沒有【回】答我
我学会了抽烟	我學會【了】抽【煙】
整天呆在家里	整天呆在家【里】
德国当地时间	德國【當】地時間
晚上吃什么了	晚上吃什麼【了】
希尔德布兰德	希爾德【佈】蘭德
我只希望你能	我【只】希望你能
什么时间回家	什麼時間【回】家
最后一滴眼泪	最【後】一滴眼淚
你在哪里工作	你在哪【里】工作
你回来的时候	你【回】來的時候
就可以回去了	就可以【回】去【了】
差错控制编码	差錯控【制】編碼
也不知道当时	也不知道【當】時
将在当地时间	將在【當】地時間
我抬头看了看	我擡頭看【了】看
楚天千里清秋	楚天【千】【里】清【秋】
的一个女同学	的一個女【同】學
但这并不意味	但這【並】不意味
回想起当时的	【回】想起【當】時的
我不喜欢别人	我不喜歡【別】人
结了婚的女人	結【了】婚的女人
程序体系结构	程序體【係】結構
异形词整理表	異形詞整理【表】
怎么样的一种	怎麼樣的一【種】
今时不同往日	今時不【同】往日
一下就过去了	一下就過去【了】
首都比什凯克	首都比什凱【克】
下半场开始后	下半場開始【後】
六方会谈代表	六方會談代【表】
劳动工资制度	勞動工資【制】度
在这段日子里	在這段日子【里】
同父异母兄弟	【同】父異母兄弟
我还是忘不了	我還是忘不【了】
我看到了你的	我看到【了】你的
面对流言蜚语	【面】對流言蜚語
他们我的幸福	他們我的【幸】福
受不了的时候	受不【了】的時候
我不想在这里	我不想在這【里】
离别后才明白	離【別】【後】【才】明白
你干什么去啊	你【幹】什麼去啊
昨天接受采访	昨天接受【採】訪
几乎同一时间	【幾】乎【同】一時間
都已经发生了	都已經【發】生【了】
什么也没干啊	什麼也沒【幹】啊
在一起就好了	在一起就好【了】
就等于放弃了	就等於放棄【了】
改善两国关系	改善兩國關【係】
广州市电视台	廣州市電視【臺】
参加世界大赛	【參】加世界大賽
这个犯罪团伙	這個犯罪【團】【夥】
是种什么样的	是【種】什麼樣的
不禁泪流满面	不禁淚流滿【面】
表现令人失望	【表】現令人失望
工程技术学会	工程技【術】學會
以后还有没有	以【後】還有沒有
踏上回家的路	踏上【回】家的路
还回来我身边	還【回】來我身邊
温暖的被窝里	溫暖的被窩【里】
平面整体表示	平【面】整體【表】示
知道自己以后	知道自己以【後】
我终于见到了	我終於見到【了】
流言蜚语只要	流言蜚語【只】要
又一年过去了	又一年過去【了】
串联重复序列	串聯重【復】序列
一汽丰田卡罗	一汽【豐】田卡羅
是不同世界的	是不【同】世界的
不管你在哪里	不管你在哪【里】
参加商业活动	【參】加商業活動
最后一朵玫瑰	最【後】一朵玫瑰
模拟控制技术	模擬控【制】技【術】
参茸三肾胶囊	【參】茸三腎膠囊
再也没有别的	再也沒有【別】的
我明白了很多	我明白【了】很多
然后头也不回	然【後】頭也不【回】
火车开往冬天	火車開往【冬】天
特别军事法庭	特【別】軍事法庭
经理信息系统	經理信息【係】統
童话故事里的	童話故事【里】的
勇敢的去面对	勇敢的去【面】對
复方黄连素片	【復】方黃連素片
永远没有尽头	永遠沒有【盡】頭
表现非常满意	【表】現非常滿意
比赛最后时刻	比賽最【後】時刻
聚氯乙烯纤维	聚氯乙烯【纖】維
我也记不清了	我也記不清【了】
都要付出代价	都要付【出】代價
控制保护装置	控【制】保護裝置
只是一个美丽	【只】是一個美麗
报道发表评论	報道【發】【表】評論
冲出你的窗口	【衝】【出】你的窗口
空气中充满了	空氣中充滿【了】
以后的每一天	以【後】的每一天
我只想好好的	我【只】想好好的
最后一个出场	最【後】一個【出】場
的成绩打破了	的成績打破【了】
密切关注官网	密切關【注】官網
成了男女朋友	成【了】男女朋友
心里很不好受	心【里】很不好受
抑制基因突变	抑【制】基因突變
明天就要走了	明天就要走【了】
还是没有回来	還是沒有【回】來
这么晚了还不	這麼晚【了】還不
用尽一切办法	用【盡】一切辦法
心里告诉自己	心【里】告訴自己
是另一种情况	是另一【種】情況
就消失不见了	就消失不見【了】
只是为了证明	【只】是爲【了】證明
文化专制主义	文化專【制】主義
玩家可以获得	玩家可以【獲】得
了雅典奥运会	【了】雅典奧運會
欢乐趣离别苦	歡樂趣離【別】苦
这么晚了还没	這麼晚【了】還沒
当地时间周二	【當】地時間【周】二
十进制计数法	十進【制】計數法
我都不记得了	我都不記得【了】
笑得前俯后仰	笑得前俯【後】仰
组织在伊拉克	組織在伊拉【克】
流下了伤心的	流下【了】傷心的
一定会有回报	一定會有【回】報
在一起很幸福	在一起很【幸】福
一定会很幸福	一定會很【幸】福
为了避免见到	爲【了】避免見到
只是随便问问	【只】是隨便問問
有计划按比例	有計【劃】按比例
保持友好关系	保持友好關【係】
回来直到现在	【回】來直到現在
就再也回不去	就再也【回】不去
统计模式识别	統計模式識【別】
平均发展水平	平均【發】展水平
历史的教科书	【歷】史的教科書
据南方都市报	【據】南方都市報
十六进制数字	十六進【制】數字
副总参谋长章	副總【參】謀長章
就再也回不来	就再也【回】不來
早已泪流满面	早已淚流滿【面】
只有一个星期	【只】有一個星期
命令控制系统	命令控【制】【係】統
找到男朋友了	找到男朋友【了】
奥林匹克试题	奧林匹【克】試題
外交代表机构	外交代【表】機構
当我坠入爱河	【當】我墜入愛河
怎么也忘不了	怎麼也忘不【了】
在那里还好吧	在那【里】還好吧
自己想干什么	自己想【幹】什麼
被别人看不起	被【別】人看不起
还是摆脱不了	還是【擺】脫不【了】
哈马斯发言人	哈馬斯【發】言人
我醉了我哭了	我醉【了】我哭【了】
据新京报报道	【據】新京報報道
要求布什政府	要求【佈】什政府
原来只是一个	原來【只】是一個
只是我们自己	【只】是我們自己
一点心理准备	一點心理【準】備
金陵酒肆留别	金陵酒肆留【別】
我的好友里面	我的好友【里】【面】
的确出人意料	的確【出】人意料
那不打扰你了	那不打擾你【了】
对你依依不舍	對你依依不【舍】
你干什么工作	你【幹】什麼工作
究竟去了哪里	究竟去【了】哪【里】
我已经学会了	我已經學會【了】
点击进入游戏	點擊進入【遊】戲
恶魔之心手套	【惡】魔之心手套
此事发表评论	此事【發】【表】評論
主帅多梅内克	主帥多梅內【克】
我怎么没发现	我怎麼沒【發】現
好聚好散以后	好聚好散以【後】
台湾电视公司	【臺】灣電視公司
先后赶到现场	先【後】趕到現場
走过千山万水	走過【千】山【萬】水
疏松结缔组织	疏【鬆】結締組織
有多长时间了	有多長時間【了】
位置控制系统	位置控【制】【係】統
她已经习惯了	她已經習慣【了】
当初为什么不	【當】初爲什麼不
回去做什么啊	【回】去做什麼啊
孤单也是一种	孤單也是一【種】
当地时间周三	【當】地時間【周】三
只想哭只想哭	【只】想哭【只】想哭
面对什么样的	【面】對什麼樣的
我也不记得了	我也不記得【了】
基本面支撑的	基本【面】支撐的
已经有了答案	已經有【了】答案
我们在一起了	我們在一起【了】
竟然发现自己	竟然【發】現自己
我怎么了哭了	我怎麼【了】哭【了】
不得不去面对	不得不去【面】對
我只不过是个	我【只】不過是個
国民党秘书长	國民【黨】秘書長
执行控制程序	執行控【制】程序
好不容易挨到	好不容易【挨】到
三千里地山河	三【千】【里】地山河
我也感觉到了	我也感覺到【了】
苏宁电器总裁	【蘇】寧電器總裁
多计算机系统	多計算機【係】統
又过了一个月	又過【了】一個月
有事回来再说	有事【回】來再說
对象建模技术	對象建模技【術】
汽车安全标准	汽車安全標【準】
新华网新德里	新華網新德【里】
剂量效应关系	劑量效應關【係】
六方会谈复会	六方會談【復】會
离开千里之外	離開【千】【里】之外
硝酸纤维素膜	硝酸【纖】維素膜
心里不免有些	心【里】不免有些
一棵参天大树	一棵【參】天大樹
据目击者介绍	【據】目擊者介紹
哪里都不知道	哪【里】都不知道
等待也是一种	等待也是一【種】
爱情只是一个	愛情【只】是一個
一点也不后悔	一點也不【後】悔
我不想让别人	我不想讓【別】人
我们的世界里	我們的世界【里】
闻名不如见面	聞名不如見【面】
有限的生命里	有限的生命【里】
好想好想回家	好想好想【回】家
亮了生日快乐	亮【了】生日快樂
只是这个世界	【只】是這個世界
警方取得联系	警方取得聯【係】
主教练朱广沪	主教練【朱】廣滬
心里总有一种	心【里】總有一【種】
传奇私服论坛	傳奇私服論【壇】
一种无可奈何	一【種】無可奈何
精彩网址推荐	精【彩】網址推薦
软件开发计划	軟件開【發】計【劃】
开心快乐幸福	開心快樂【幸】福
当着那么多人	【當】著那麼多人
如何才能拯救	如何【才】能拯救
软件开发手册	軟件開【發】手冊
随后发表声明	隨【後】【發】【表】聲明
那就不要看了	那就不要看【了】
注册热血江湖	【注】冊熱血江湖
特种加工机床	特【種】加工機床
目前网络游戏	目前網絡【遊】戲
不小心错过了	不小心錯過【了】
在我面前的是	在我【面】前的是
也不知道以后	也不知道以【後】
为了心爱的人	爲【了】心愛的人
北京市出租车	北京市【出】租車
一直没有回来	一直沒有【回】來
主帅斯科拉里	主帥斯科拉【里】
怎么现在才上	怎麼現在【才】上
首款自主研发	首款自主研【發】
转瞬间消灭了	轉瞬間消滅【了】
到最后受伤的	到最【後】受傷的
幸福隔着玻璃	【幸】福隔著玻璃
是否已经有了	是否已經有【了】
问题恢复谈判	問題恢【復】談判
就不会再回来	就不會再【回】來
新华社记者朱	新華社記者【朱】
我当然知道你	我【當】然知道你
丢到九霄云外	丟到九霄【雲】外
说不出的感动	說不【出】的感動
只是心情不好	【只】是心情不好
发射光谱分析	【發】射光譜分析
乘客当场死亡	乘客【當】場死亡
为了自己心爱	爲【了】自己心愛
今天是中秋节	今天是中【秋】節
怎么也想不出	怎麼也想不【出】
标准起草小组	標【準】起草小組
并发程序设计	【並】【發】程序設計
就是控制不住	就是控【制】不住
面前表现出来	【面】前【表】現【出】來
又再回到从前	又再【回】到從前
就成了好朋友	就成【了】好朋友
呈现在我面前	呈現在我【面】前
悬崖千钧一发	懸崖【千】鈞一【發】
知道要干什么	知道要【幹】什麼
不会在回来了	不會在【回】來【了】
自伊拉克战争	自伊拉【克】戰爭
复方罗布麻片	【復】方羅【佈】麻片
恶魔之心护腕	【惡】魔之心護腕
走进了婚姻的	走進【了】婚姻的
游戏中的各种	【遊】戲中的各【種】
只是生活中的	【只】是生活中的
我只是一个人	我【只】是一個人
在你眼里到底	在你眼【里】到底
信息存储技术	信息存儲技【術】
都是为了我们	都是爲【了】我們
俱乐部成立了	俱樂部成立【了】
你怎么不回啊	你怎麼不【回】啊
生命维持系统	生命維持【係】統
我等你好久了	我等你好久【了】
问我怎么回事	問我怎麼【回】事
第一次回老家	第一次【回】老家
驱动传动系统	驅動傳動【係】統
布列斯特和约	【佈】列斯特和約
自主研发游戏	自主研【發】【遊】戲
中国医药学院	中國醫【藥】學院
每个春夏秋冬	每個春夏【秋】【冬】
说出口再给我	說【出】口再給我
内核数据结构	內核數【據】結構
代销旅游产品	代銷旅【遊】產品
已经很难回头	已經很難【回】頭
只是在最适合	【只】是在最適合
标准保险公司	標【準】保險公司
的时间出现的	的時間【出】現的
一切都是注定	一切都是【注】定
也是一种无奈	也是一【種】無奈
我们一起回家	我們一起【回】家
消息据法新社	消息【據】法新社
我马上要下了	我馬上要下【了】
我和他分手了	我和他分手【了】
最近发现自己	最近【發】現自己
当时是怎么想	【當】時是怎麼想
就是命中注定	就是命中【注】定
我的心里还是	我的心【里】還是
从目前公布的	從目前公【佈】的
城市历史地理	城市【歷】史地理
面前你不知道	【面】前你不知道
被老板炒鱿鱼	被老【板】炒魷魚
保险外汇资金	保險外【匯】資金
我学会了如何	我學會【了】如何
丑话说在前头	【醜】話說在前頭
人生就是为了	人生就是爲【了】
那种刻骨铭心	那【種】刻骨銘心
同学们一个个	【同】學們一個個
四冲程内燃机	四【衝】程內燃機
喝得差不多了	喝得差不多【了】
都已经结束了	都已經結束【了】
主动提出分手	主動提【出】分手
自动频率控制	自動頻率控【制】
我不在乎别人	我不在乎【別】人
好久没联系了	好久沒聯【係】【了】
游戏中收录了	【遊】戲中收錄【了】
游戏在线人数	【遊】戲在線人數
幸福就在眼前	【幸】福就在眼前
遥想公谨当年	遙想公謹【當】年
官方网站宣布	官方網站宣【佈】
当地时间晚上	【當】地時間晚上
查里斯特亚斯	查【里】斯特亞斯
在很多人面前	在很多人【面】前
知道如何面对	知道如何【面】對
结了婚的男人	結【了】婚的男人
总参谋长助理	總【參】謀長助理
好男不跟女斗	好男不跟女【鬭】
战胜中国台北	戰勝中國【臺】北
法术命中等级	法【術】命中等級
就是为了找寻	就是爲【了】找尋
准拟佳期又误	【準】擬佳期又誤
我心里充满了	我心【里】充滿【了】
也许只是为了	也許【只】是爲【了】
英国首相托尼	英國首相【托】尼
我学会了坚强	我學會【了】堅強
放手也是一种	放手也是一【種】
过去了就过去	過去【了】就過去
复方利血平片	【復】方利血平片
骨折挫伤胶囊	骨【折】挫傷膠囊
据新华网消息	【據】新華網消息
回去好好休息	【回】去好好休息
我仿佛看见了	我仿佛看見【了】
分布式多媒体	分【佈】式多媒體
手机彩信图片	手機【彩】信圖片
什么时候来了	什麼時候來【了】
恶魔之心护肩	【惡】魔之心護肩
注定没有结果	【注】定沒有結果
说出那样的话	說【出】那樣的話
售后质量保证	售【後】質量保證
为了能让自己	爲【了】能讓自己
真主党游击队	真主【黨】【遊】擊隊
赛后接受采访	賽【後】接受【採】訪
凯迪拉克品牌	凱迪拉【克】品牌
你是在家里吗	你是在家【里】嗎
进军网络游戏	進軍網絡【遊】戲
风风雨雨之后	風風雨雨之【後】
强虏灰飞烟灭	強虜灰飛【煙】滅
现实的世界里	現實的世界【里】
提高技术性能	提高技【術】性能
启发式教育法	啓【發】式教育法
电视画面显示	電視畫【面】顯示
天然气出口国	天然氣【出】口國
还是控制不住	還是控【制】不住
我就不一样了	我就不一樣【了】
招待会上宣布	招待會上宣【佈】
发现自己现在	【發】現自己現在
故事结束之后	故事結束之【後】
最后一个夜晚	最【後】一個夜晚
冲击强度试验	【衝】擊強度試驗
是痛并快乐着	是痛【並】快樂著
说些什么才好	說些什麼【才】好
向国际原子能	【向】國際原子能
就表示你已经	就【表】示你已經
主教练裴恩才	主教練裴恩【才】
也已经习惯了	也已經習慣【了】
桌子上睡着了	桌子上睡著【了】
为什么只有我	爲什麼【只】有我
也不知道这种	也不知道這【種】
赛会头号种子	賽會頭號【種】子
传遍了全世界	傳遍【了】全世界
我的手机掉了	我的手機掉【了】
最后一个动作	最【後】一個動作
纸里包不住火	紙【里】包不住火
加快开发进度	加快開【發】進度
不小心掉进了	不小心掉進【了】
下一个人回答	下一個人【回】答
后来他告诉我	【後】來他告訴我
刚才在玩游戏	剛【才】在玩【遊】戲
无法呼吸只能	無法呼吸【只】能
其实有一种爱	其實有一【種】愛
就在我的面前	就在我的【面】前
然后转身离开	然【後】轉身離開
这段时间注意	這段時間【注】意
网络游戏作为	網絡【遊】戲作爲
都有男朋友了	都有男朋友【了】
丹参舒心胶囊	丹【參】舒心膠囊
就这么放弃了	就這麼放棄【了】
也是一种收获	也是一【種】收【獲】
民族团结政府	民族【團】結政府
无法控制自己	無法控【制】自己
我已经爱上了	我已經愛上【了】
怎么联系你啊	怎麼聯【係】你啊
金融运行数据	金融運行數【據】
回到了小时候	【回】到【了】小時候
怎么做才可以	怎麼做【才】可以
只是擦肩而过	【只】是擦肩而過
一直没有联系	一直沒有聯【係】
恶魔之心腰带	【惡】魔之心腰帶
我舍不得离开	我【舍】不得離開
还是没有回答	還是沒有【回】答
只是一个游戏	【只】是一個【遊】戲
驻扎在伊拉克	駐【扎】在伊拉【克】
电子会议系统	電子會議【係】統
国际标准草案	國際標【準】草案
感觉都没有了	感覺都沒有【了】
一种幸福叫做	一【種】【幸】福叫做
我心中另一种	我心中另一【種】
舍不得离开你	【舍】不得離開你
并将正确答案	【並】將正確答案
曲终人散谁无	【曲】終人散誰無
我的心里没有	我的心【里】沒有
影像交换系统	影像交換【係】統
文书处理系统	文書處理【係】統
发现自己什么	【發】現自己什麼
基因资源开发	基因資源開【發】
标准管理费用	標【準】管理費用
室内排水系统	室內排水【係】統
新产品试制费	新產品試【制】費
到最后才发现	到最【後】【才】【發】現
既然你选择了	既然你選擇【了】
监督检验周期	監督檢驗【周】期
克里米亚半岛	【克】【里】米亞半島
只是我不明白	【只】是我不明白
汉字输入技术	漢字輸入技【術】
我要去上班了	我要去上班【了】
过去这么久了	過去這麼久【了】
这么晚了还上	這麼晚【了】還上
满口胡说八道	滿口【胡】說八道
开启外交关系	開啓外交關【係】
语言表达信息	語言【表】達信息
经历一些事情	經【歷】一些事情
摩尔吸光系数	摩爾吸光【係】數
可以回到过去	可以【回】到過去
点燃了一支烟	點燃【了】一支【煙】
万夫不当之勇	【萬】夫不【當】之勇
运营网络游戏	運營網絡【遊】戲
这个世界除了	這個世界除【了】
一场酣畅淋漓	一場酣暢淋【漓】
卡通网络游戏	卡通網絡【遊】戲
进行了核试验	進行【了】核試驗
数据描述语言	數【據】描述語言
文献检索系统	文獻檢索【係】統
我实在找不出	我實在找不【出】
无法面对自己	無法【面】對自己
当地时间周一	【當】地時間【周】一
各向异性介质	各【向】異性介質
怎么还不回家	怎麼還不【回】家
流下了一滴泪	流下【了】一滴淚
我要去睡觉了	我要去睡覺【了】
她爱上了一个	她愛上【了】一個
付出一切代价	付【出】一切代價
当时我的心情	【當】時我的心情
疯狂的爱上了	瘋狂的愛上【了】
联合国发言人	聯合國【發】言人
只是他们自己	【只】是他們自己
输入输出管理	輸入輸【出】管理
我希望你幸福	我希望你【幸】福
下一页更精彩	下一頁更精【彩】
说不出的喜悦	說不【出】的喜悅
爱过了心碎了	愛過【了】心碎【了】
你吃饭了没啊	你吃飯【了】沒啊
忘得一干二净	忘得一【幹】二凈
发动军事打击	【發】動軍事打擊
如同行尸走肉	如【同】行【屍】走肉
妇科千金洗液	婦科【千】金洗液
发现自己有点	【發】現自己有點
我回头看了看	我【回】頭看【了】看
完全面向用户	完全【面】【向】用戶
吉布斯自由能	吉【佈】斯自由能
忘不了你时间	忘不【了】你時間
游戏点击此处	【遊】戲點擊此處
你干什么去了	你【幹】什麼去【了】
博采各家之长	博【採】各家之長
无线电发射机	無線電【發】射機
不准随地吐痰	不【準】隨地吐痰
早请示晚汇报	早請示晚【匯】報
过程控制软件	過程控【制】軟件
就是一场游戏	就是一場【遊】戲
千里澄江似练	【千】【里】澄江似練
已经到了尽头	已經到【了】【盡】頭
伦敦爱乐乐团	倫敦愛樂樂【團】
那种撕心裂肺	那【種】撕心裂肺
可是到了晚上	可是到【了】晚上
多年望眼欲穿	多年望眼【欲】穿
我玩游戏去了	我玩【遊】戲去【了】
一面表现出来	一【面】【表】現【出】來
我并没有觉得	我【並】沒有覺得
武装人员当天	武裝人員【當】天
感觉又回来了	感覺又【回】來【了】
经济调控体系	經濟調控體【係】
克罗地亚选手	【克】羅地亞選手
更多精彩活动	更多精【彩】活動
这么晚了还在	這麼晚【了】還在
男人和女人才	男人和女人【才】
消息处理系统	消息處理【係】統
侵蚀的世界里	侵蝕的世界【里】
比赛中表现出	比賽中【表】現【出】
虱子多了不痒	虱子多【了】不癢
但是我的心里	但是我的心【里】
无线电收发机	無線電收【發】機
一个春夏秋冬	一個春夏【秋】【冬】
一位发言人称	一位【發】言人稱
正是为了爱才	正是爲【了】愛【才】
真不知道以后	真不知道以【後】
人机环境系统	人機環境【係】統
懂得珍惜以后	懂得珍惜以【後】
专科学校建筑	專科學校建【築】
要坚持到最后	要堅持到最【後】
雄风不减当年	雄風不減【當】年
想了好久好久	想【了】好久好久
自动音量控制	自動音量控【制】
又有什么分别	又有什麼分【別】
自主访问控制	自主訪問控【制】
叶声声是别离	葉聲聲是【別】離
不是为了别的	不是爲【了】【別】的
又是一个周末	又是一個【周】末
以后的生活会	以【後】的生活會
初中同学聚会	初中【同】學聚會
我终于等到了	我終於等到【了】
我不是那种人	我不是那【種】人
不敢面对自己	不敢【面】對自己
我还会回来的	我還會【回】來的
就什么都没了	就什麼都沒【了】
一点都不后悔	一點都不【後】悔
从开始到最后	從開始到最【後】
雅典当地时间	雅典【當】地時間
数据传输指令	數【據】傳輸指令
发生的最严重	【發】生的最嚴重
警方发生冲突	警方【發】生【衝】突
给予密切关注	給予密切關【注】
强化邪恶攻击	強化邪【惡】攻擊
经历风风雨雨	經【歷】風風雨雨
一件千回百转	一件【千】【回】百轉
我是一个特别	我是一個特【別】
城市电力系统	城市電力【係】統
一下子长大了	一下子長大【了】
有事电话联系	有事電話聯【係】
别人的女朋友	【別】人的女朋友
不是为了生气	不是爲【了】生氣
苹果树腐烂病	【蘋】果樹腐爛病
民主党众议员	民主【黨】眾議員
我错了还不行	我錯【了】還不行
刚吃完饭回来	剛吃完飯【回】來
可以为了自己	可以爲【了】自己
出现在训练场	【出】現在訓練場
讲得很清楚了	講得很清楚【了】
火焰法术伤害	火焰法【術】傷害
寒冷的季节里	寒冷的季節【里】
打游戏的时候	打【遊】戲的時候
说服不了自己	說服不【了】自己
真的很舍不得	真的很【舍】不得
恶魔之心短裤	【惡】魔之心短褲
永远在一起了	永遠在一起【了】
分级存储系统	分級存儲【係】統
考了就结束了	考【了】就結束【了】
一种什么感觉	一【種】什麼感覺
表现感到满意	【表】現感到滿意
氯化钾注射液	氯化鉀【注】射液
对情况不了解	對情況不【了】解
醋酸泼尼松龙	醋酸潑尼【鬆】龍
游手好闲之人	【遊】手好閑之人
游戏性感美女	【遊】戲性感美女
好男不与女斗	好男不與女【鬭】
原子能发电站	原子能【發】電站
我已经麻木了	我已經麻木【了】
就发生在昨天	就【發】生在昨天
不知道去哪了	不知道去哪【了】
什克洛夫斯基	什【克】洛夫斯基
该怎么做才好	該怎麼做【才】好
岛国经济发展	島國經濟【發】展
只有一个名字	【只】有一個名字
想起了去年的	想起【了】去年的
杰梅因奥尼尔	【傑】梅因奧尼爾
事发现场看到	事【發】現場看到
世界杯结束后	世界杯結束【後】
一下子说不出	一下子說不【出】
玩什么游戏呢	玩什麼【遊】戲呢
唤取归来同住	喚取歸來【同】住
随后赶到现场	隨【後】趕到現場
回忆的一部分	【回】憶的一部分
只能顺其自然	【只】能順其自然
有些事情必须	有些事情必【須】
非制造业指数	非【制】造業指數
心里到底在想	心【里】到底在想
行尸走肉般的	行【屍】走肉般的
可能是另一种	可能是另一【種】
谁又遇见了你	誰又遇見【了】你
失去后才知道	失去【後】【才】知道
你在干什么那	你在【幹】什麼那
密切关注我们	密切關【注】我們
敌方战斗人员	敵方戰【鬭】人員
最后关头而你	最【後】關頭而你
米洛舍维奇的	米洛【舍】維奇的
以后不要这样	以【後】不要這樣
学习怎么样了	學習怎麼樣【了】
斯托克斯公式	斯【托】【克】斯公式
给你带来幸福	給你帶來【幸】福
不要回头明天	不要【回】頭明天
摩托车包围了	摩【托】車包圍【了】
付出无怨无悔	付【出】無怨無悔
哭的稀里哗啦	哭的稀【里】嘩啦
建筑标准图集	建【築】標【準】圖集
开了个双人间	開【了】個雙人間
复方新诺明片	【復】方新諾明片
在我心里一直	在我心【里】一直
放弃了梦醒了	放棄【了】夢醒【了】
桌面出版系统	桌【面】【出】版【係】統
非流通股东向	非流通股東【向】
和他只是朋友	和他【只】是朋友
讲完那就算了	講完那就算【了】
只是一个玩笑	【只】是一個玩笑
摆到桌面上来	【擺】到桌【面】上來
突然觉得心里	突然覺得心【里】
游戏时间超过	【遊】戲時間超過
牙本质过敏症	牙本質過敏【症】
慢慢的变成了	慢慢的變成【了】
别爱我别爱我	【別】愛我【別】愛我
就业招生计划	就業招生計【劃】
冲击电压试验	【衝】擊電壓試驗
不是为了别人	不是爲【了】【別】人
在以后的路上	在以【後】的路上
甜美的红苹果	甜美的紅【蘋】果
战略数据规划	戰略數【據】規【劃】
摸了摸我的头	摸【了】摸我的頭
不知道去那里	不知道去那【里】
磁盘冗余阵列	磁盤冗【餘】陣列
汉字识别系统	漢字識【別】【係】統
我已经受够了	我已經受夠【了】
恶魔之心长袍	【惡】魔之心長袍
敬请密切关注	敬請密切關【注】
毫无共同之处	毫無共【同】之處
当以涌泉相报	【當】以涌泉相報
不该到哪里找	不該到哪【里】找
新华网布拉格	新華網【佈】拉格
抗恶性肿瘤药	抗【惡】性腫瘤【藥】
真主党总书记	真主【黨】總書記
在她的世界里	在她的世界【里】
昨夜松边醉倒	昨夜【鬆】邊醉倒
秘密行动计划	秘密行動計【劃】
明天就要回家	明天就要【回】家
一种说不清的	一【種】說不清的
算术运算逻辑	算【術】運算邏輯
进入同业拆借	進入【同】業拆【借】
玩什么游戏呀	玩什麼【遊】戲呀
倒塌了我不管	倒塌【了】我不管
非全日制职工	非全日【制】職工
我的生活放荡	我的生活放【蕩】
国民大会代表	國民大會代【表】
对着镜子里的	對著鏡子【里】的
蜷缩在角落里	蜷縮在角落【里】
不只我一个人	不【只】我一個人
现在还没回来	現在還沒【回】來
输卵管切除术	輸卵管切除【術】
云青青兮欲雨	【雲】青青兮【欲】雨
再也不能回到	再也不能【回】到
他已经离开了	他已經離開【了】
在那边干什么	在那邊【幹】什麼
流出来的时候	流【出】來的時候
只是需要时间	【只】是需要時間
很幸福的生活	很【幸】福的生活
然而横冲直撞	然而橫【衝】直撞
有什么关系呀	有什麼關【係】呀
我也要回去了	我也要【回】去【了】
不远千里而来	不遠【千】【里】而來
也不可能回到	也不可能【回】到
所爱的人幸福	所愛的人【幸】福
第二节开始后	第二節開始【後】
粘液表皮样癌	粘液【表】皮樣癌
太在意别人的	太在意【別】人的
再回来的时候	再【回】來的時候
当然是真的了	【當】然是真的【了】
丧失了爱情的	喪失【了】愛情的
都取得了胜利	都取得【了】勝利
共同社报道称	共【同】社報道稱
总是意犹未尽	總是意猶未【盡】
参加上星期六	【參】加上星期六
化纤混纺织物	化【纖】混紡織物
马上就要走了	馬上就要走【了】
最幸福的生活	最【幸】福的生活
我已经得到了	我已經得到【了】
能够幸福快乐	能夠【幸】福快樂
发现一切都是	【發】現一切都是
人为万物之灵	人爲【萬】物之靈
合格认证标志	合格認證標【志】
云窗雾阁春迟	【雲】窗霧閣春遲
代表团发言人	代【表】【團】【發】言人
是最好的良药	是最好的良【藥】
链路控制规程	【鏈】路控【制】規程
作业控制语言	作業控【制】語言
轻松战胜对手	輕【鬆】戰勝對手
放在心里而是	放在心【里】而是
不了解我的人	不【了】解我的人
台北师范学院	【臺】北師【範】學院
我尽量让自己	我【盡】量讓自己
关注官方主页	關【注】官方主頁
总觉得少了点	總覺得少【了】點
记得最后一次	記得最【後】一次
网络游戏方面	網絡【遊】戲方【面】
法术致命一击	法【術】【致】命一擊
我现在很幸福	我現在很【幸】福
多情的人注定	多情的人【注】定
孤独也是一种	孤獨也是一【種】
包围了料理店	包圍【了】料理店
从日出到日落	從日【出】到日落
与其它不同的	與其它不【同】的
发生很多事情	【發】生很多事情
爱你最后一幕	愛你最【後】一幕
一点一点沉淀	一點一點沉【澱】
我已经离开了	我已經離開【了】
我错过了很多	我錯過【了】很多
这也太大胆了	這也太大膽【了】
归来华发苍颜	歸來華【發】蒼顏
一具行尸走肉	一具行【屍】走肉
我只是想和你	我【只】是想和你
为了逃避现实	爲【了】逃避現實
千万不要当真	【千】【萬】不要【當】真
回味我的世界	【回】味我的世界
这个大千世界	這個大【千】世界
不愉快的回忆	不愉快的【回】憶
一直走到最后	一直走到最【後】
谷氨酸合成酶	【谷】氨酸合成酶
人才兴企战略	人【才】興企戰略
马德里竞技队	馬德【里】競技隊
才会懂得珍惜	【才】會懂得珍惜
等到了这一天	等到【了】這一天
在感情世界里	在感情世界【里】
那一刻我哭了	那一刻我哭【了】
眼泪掉下来了	眼淚掉下來【了】
我终于来到了	我終於來到【了】
中美外交关系	中美外交關【係】
马上要毕业了	馬上要畢業【了】
现在在哪里呢	現在在哪【里】呢
布洛芬混悬液	【佈】洛芬混懸液
游戏点卡在线	【遊】戲點卡在線
谙尽孤眠滋味	諳【盡】孤眠滋味
克劳福德农场	【克】勞福德農場
操作系统病毒	操作【係】統病毒
有男朋友了吗	有男朋友【了】嗎
希望你能了解	希望你能【了】解
那么多人面前	那麼多人【面】前
的时候给了我	的時候給【了】我
我的心里已经	我的心【里】已經
当地时间昨天	【當】地時間昨天
强效治疗药水	強效治療【藥】水
现在回头想想	現在【回】頭想想
我并不是因为	我【並】不是因爲
共享操作系统	共享操作【係】統
现场采访活动	現場【採】訪活動
今天我才发现	今天我【才】【發】現
一万个不愿意	一【萬】個不願意
能不喜出望外	能不喜【出】望外
盐酸曲马多片	鹽酸【曲】馬多片
回忆起过去的	【回】憶起過去的
眼前万里江山	眼前【萬】【里】江山
塞纳里奥要塞	塞納【里】奧要塞
好久没上网了	好久沒上網【了】
欧洲共同市场	歐洲共【同】市場
面对这个事实	【面】對這個事實
所以我放弃了	所以我放棄【了】
强化法术反制	強化法【術】反【制】
哪个才是真正	哪個【才】是真正
只有一个转身	【只】有一個轉身
链球菌溶血素	【鏈】球菌溶血素
装进贴图论坛	裝進貼圖論【壇】
发生也不一定	【發】生也不一定
我也不清楚了	我也不清楚【了】
医学专业词汇	醫學專業詞【匯】
平淡的日子里	平淡的日子【里】
现在不知道了	現在不知道【了】
冰霜法术伤害	冰霜法【術】傷害
万物皆备于我	【萬】物皆備於我
在某个角落里	在某個角落【里】
昏暗的路灯下	昏【暗】的路燈下
换了手机号码	換【了】手機號碼
别人生命中的	【別】人生命中的
只是情深缘浅	【只】是情深緣淺
一切只是因为	一切【只】是因爲
苯扎溴铵溶液	苯【扎】溴銨溶液
们第一次见面	們第一次見【面】
为了所爱的人	爲【了】所愛的人
不想那么多了	不想那麼多【了】
新华网里斯本	新華網【里】斯本
电据外电报道	電【據】外電報道
实行双向收费	實行雙【向】收費
凯迪拉克推出	凱迪拉【克】推【出】
只有一只翅膀	【只】有一【只】翅膀
恶魔之心便鞋	【惡】魔之心便鞋
只是有的时候	【只】是有的時候
眼里我是一个	眼【里】我是一個
发给你关心的	【發】給你關心的
青楼薄幸名存	青樓薄【幸】名存
真的不记得了	真的不記得【了】
终于在一起了	終於在一起【了】
提高法术伤害	提高法【術】傷害
一会儿再联系	一會兒再聯【係】
我和她的关系	我和她的關【係】
缩微摄影技术	縮微攝影技【術】
中原标准时间	中原標【準】時間
后备保护装置	【後】備保護裝置
工艺技术参数	工藝技【術】【參】數
恶魔之心角饰	【惡】魔之心角飾
新方向往前走	新方【向】往前走
数据控制语言	數【據】控【制】語言
无线电导航台	無線電導航【臺】
我明白了自己	我明白【了】自己
相隔千山万水	相隔【千】山【萬】水
一千个一万个	一【千】個一【萬】個
面向对象表示	【面】【向】對象【表】示
有限无敌药水	有限無敵【藥】水
老虎嘴里拔牙	老虎嘴【里】拔牙
多布罗斯科克	多【佈】羅斯科【克】
工作找到了吗	工作找到【了】嗎
心里有一点点	心【里】有一點點
在同一个学校	在【同】一個學校
我只能眼睁睁	我【只】能眼睜睜
沉浸在回忆中	沉浸在【回】憶中
我不会忘了你	我不會忘【了】你
也许只有一个	也許【只】有一個
回学校的路上	【回】學校的路上
没有发现而已	沒有【發】現而已
回来的那一天	【回】來的那一天
三里河旅行社	三【里】河旅行社
然后告诉自己	然【後】告訴自己
真的是太累了	真的是太纍【了】
终于抑制不住	終於抑【制】不住
一伙不明身份	一【夥】不明身份
制片人张伟平	【制】片人張偉平
走过春夏秋冬	走過春夏【秋】【冬】
中国武器论坛	中國武器論【壇】
占优的情况下	【佔】優的情況下
晚上吃饭了吗	晚上吃飯【了】嗎
抑制性突触后	抑【制】性突觸【後】
同业拆借管理	【同】業拆【借】管理
在那里做什么	在那【里】做什麼
你在玩游戏吗	你在玩【遊】戲嗎
知道自己心里	知道自己心【里】
好久不见了啊	好久不見【了】啊
爱情只不过是	愛情【只】不過是
和她在一起了	和她在一起【了】
心爱的人面前	心愛的人【面】前
飞船遨游太空	飛船遨【遊】太空
俄克拉何马城	俄【克】拉何馬城
习惯了这里的	習慣【了】這【里】的
只是想找一个	【只】是想找一個
安痛定注射液	安痛定【注】射液
离散控制系统	離散控【制】【係】統
选择了就不要	選擇【了】就不要
物理访问控制	物理訪問控【制】
热水采暖系统	熱水【採】暖【係】統
同生死共存亡	【同】生死共存亡
纤毛柱状上皮	【纖】毛柱狀上皮
汉字编码技术	漢字編碼技【術】
南台湾小姑娘	南【臺】灣小姑【娘】
我才发现其实	我【才】【發】現其實
刚才吃饭去了	剛【才】吃飯去【了】
爱你并不容易	愛你【並】不容易
在训练结束后	在訓練結束【後】
家庭网络向导	家庭網絡【向】導
更是一种幸福	更是一【種】【幸】福
西洋参口服液	西洋【參】口服液
寂寞的人不同	寂寞的人不【同】
我有事要下了	我有事要下【了】
游戏中的任务	【遊】戲中的任務
挽着我的胳膊	【挽】著我的胳膊
我们不约而同	我們不約而【同】
桃金娘科植物	桃金【娘】科植物
一千遍一万遍	一【千】遍一【萬】遍
最后一次为你	最【後】一次爲你
获得联赛冠军	【獲】得聯賽冠軍
沙尔克体育场	沙爾【克】體育場
万千心事难寄	【萬】【千】心事難寄
移交给伊拉克	移交給伊拉【克】
体系博大精深	體【係】博大精深
硫酸镁注射液	硫酸鎂【注】射液
文件编制系统	文件編【制】【係】統
交叉链接文件	交叉【鏈】接文件
还是一样夜里	還是一樣夜【里】
系统控制文件	【係】統控【制】文件
给了我无限的	給【了】我無限的
航天系统公司	航天【係】統公司
多种断点续传	多【種】斷點續傳
是我的心里话	是我的心【里】話
直接数字控制	直接數字控【制】
奥术精准护腕	奧【術】精【準】護腕
也是一种负担	也是一【種】負擔
今天干什么了	今天【幹】什麼【了】
进入最后一节	進入最【後】一節
出口产品基地	【出】口產品基地
已经承受不了	已經承受不【了】
其实我的心里	其實我的心【里】
最后一次拥抱	最【後】一次擁抱
陈谷子烂芝麻	陳【谷】子爛芝麻
寂寞当年萧鼓	寂寞【當】年蕭鼓
地图数据结构	地圖數【據】結構
冥冥之中注定	冥冥之中【注】定
只希望有一天	【只】希望有一天
因为我爱上了	因爲我愛上【了】
以手推松曰去	以手推【鬆】曰去
老师苏格拉底	老師【蘇】格拉底
如坠五里雾中	如墜五【里】霧中
反向击穿电压	反【向】擊穿電壓
符文岩石护肩	符文【巖】石護肩
地面飞行控制	地【面】飛行控【制】
爱情的国度里	愛情的國度【里】
暗影法术伤害	【暗】影法【術】傷害
好久没见面了	好久沒見【面】【了】
黑暗之心短裤	黑【暗】之心短褲
但是在我心里	但是在我心【里】
你有男朋友了	你有男朋友【了】
静脉回心血量	靜脈【回】心血量
给我发过来啊	給我【發】過來啊
面向对象测试	【面】【向】對象測試
死了都要爱不	死【了】都要愛不
我的心里总是	我的心【里】總是
了胡锦涛主席	【了】【胡】錦濤主席
回到了最初的	【回】到【了】最初的
我才明白自己	我【才】明白自己
这样才能证明	這樣【才】能證明
若有知音见采	若有知音見【採】
面对那么多的	【面】對那麼多的
比以前成熟了	比以前成熟【了】
桌面印刷系统	桌【面】印刷【係】統
几个知心朋友	【幾】個知心朋友
开不了口让她	開不【了】口讓她
层次数据模型	層次數【據】模型
做错了什么吗	做錯【了】什麼嗎
就什么都忘了	就什麼都忘【了】
暗影防护药水	【暗】影防護【藥】水
我该怎样面对	我該怎樣【面】對
啥时候回来啊	啥時候【回】來啊
欧几里得空间	歐【幾】【里】得空間
只能自行了断	【只】能自行【了】斷
多路传输系统	多路傳輸【係】統
暗影烈焰法杖	【暗】影烈焰法杖
云窗雾阁常扃	【雲】窗霧閣常扃
然后微微一笑	然【後】微微一笑
干什么工作啊	【幹】什麼工作啊
参加八国集团	【參】加八國集【團】
免费游戏时间	免費【遊】戲時間
我要洗澡去了	我要洗澡去【了】
网状激活系统	網狀激活【係】統
法兰克人球场	法蘭【克】人球場
最后一次这样	最【後】一次這樣
率先打破僵局	率先打破【僵】局
我当时真的是	我【當】時真的是
连续冲击试验	連續【衝】擊試驗
纯净思想斗篷	純凈思想【鬭】篷
白血球减少症	白血球減少【症】
系统使用期限	【係】統使用期限
我只能对你说	我【只】能對你說
后悔寂寞沙洲	【後】悔寂寞沙洲
我都看在眼里	我都看在眼【里】
只需要一分钟	【只】需要一分【鍾】
财政包干体制	財政包【幹】體【制】
液压升降机械	液壓【升】降機械
实在太无聊了	實在太無聊【了】
紧急处理系统	緊急處理【係】統
不怕官只怕管	不怕官【只】怕管
我要吃饭去了	我要吃飯去【了】
循环冗余检验	循環冗【餘】檢驗
我们宿舍的人	我們宿【舍】的人
我和她分手了	我和她分手【了】
委托加工货物	委【托】加工貨物
商业数据交换	商業數【據】交換
新华网马德里	新華網馬德【里】
带我离开这里	帶我離開這【里】
汉语语音识别	漢語語音識【別】
只有相信自己	【只】有相信自己
明人不说暗话	明人不說【暗】話
海洋石油技术	海洋石油技【術】
设计开发单位	設計開【發】單位
我们一起面对	我們一起【面】對
翻成雨恨云愁	翻成雨恨【雲】愁
挽回这段感情	【挽】【回】這段感情
风湿性心脏炎	風濕性心【髒】炎
你刚才是不是	你剛【才】是不是
