意见反馈留言板	意見反饋留言【板】
药品监督管理局	【藥】品監督管理局
高等教育出版社	高等教育【出】版社
清华大学出版社	清華大學【出】版社
中国经济发展的	中國經濟【發】展的
澳门特别行政区	澳門特【別】行政區
落实科学发展观	落實科學【發】展觀
质量技术监督局	質量技【術】監督局
机械工业出版社	機械工業【出】版社
房地产开发项目	房地產開【發】項目
计算机信息系统	計算機信息【係】統
有一种说不出的	有一【種】說不【出】的
党员先进性教育	【黨】員先進性教育
上海人民出版社	上海人民【出】版社
控制不住自己的	控【制】不住自己的
召开新闻发布会	召開新聞【發】【佈】會
进出口有限公司	進【出】口有限公司
社会主义制度的	社會主義【制】度的
房地产开发投资	房地產開【發】投資
电子工业出版社	電子工業【出】版社
的房地产开发商	的房地產開【發】商
土地使用权出让	土地使用權【出】讓
人民邮电出版社	人民郵電【出】版社
在新闻发布会上	在新聞【發】【佈】會上
比去年同期增长	比去年【同】期增長
房地产开发企业	房地產開【發】企業
北京大学出版社	北京大學【出】版社
发生了巨大变化	【發】生【了】巨大變化
新的历史条件下	新的【歷】史條件下
到底是怎么回事	到底是怎麼【回】事
忍不住笑了起来	忍不住笑【了】起來
全面协调可持续	全【面】協調可持續
人民教育出版社	人民教育【出】版社
什么都不记得了	什麼都不記得【了】
教育改革与发展	教育改革與【發】展
香港特别行政区	香港特【別】行政區
技术的飞速发展	技【術】的飛速【發】展
若干问题的意见	若【幹】問題的意見
胡锦涛总书记在	【胡】錦濤總書記在
文化的前进方向	文化的前進方【向】
充分发挥自己的	充分【發】揮自己的
科学发展观统领	科學【發】展觀統領
主要表现在以下	主要【表】現在以下
特别是领导干部	特【別】是領導【幹】部
解除劳动合同的	解除勞動合【同】的
科学发展观要求	科學【發】展觀要求
人民文学出版社	人民文學【出】版社
提供了强有力的	提供【了】強有力的
国家外汇管理局	國家外【匯】管理局
国家发展改革委	國家【發】展改革委
我找到了自己的	我找到【了】自己的
总书记的党中央	總書記的【黨】中央
注册会计师考试	【注】冊會計師考試
经济技术开发区	經濟技【術】開【發】區
提出了具体要求	提【出】【了】具體要求
与上年同期相比	與上年【同】期相比
高致病性禽流感	高【致】病性禽流感
发生了很大变化	【發】生【了】很大變化
到什么时候才能	到什麼時候【才】能
有一种说不出来	有一【種】說不【出】來
中国互联网发展	中國互聯網【發】展
起到了积极作用	起到【了】積極作用
发展计划委员会	【發】展計【劃】委員會
马克思列宁主义	馬【克】思列寧主義
国家统计局公布	國家統計局公【佈】
也没什么大不了	也沒什麼大不【了】
中国中央电视台	中國中央電視【臺】
全球中文论坛网	全球中文論【壇】網
与众不同的地方	與眾不【同】的地方
特别值得一提的	特【別】值得一提的
遇到困难的时候	遇到【困】難的時候
化学工业出版社	化學工業【出】版社
举行新闻发布会	舉行新聞【發】【佈】會
计算机网络技术	計算機網絡技【術】
马克思主义哲学	馬【克】思主義哲學
规划设计研究院	規【劃】設計研究院
中国共产党领导	中國共產【黨】領導
若干问题的解释	若【幹】問題的解釋
系列笔记本电脑	【係】列筆記本電腦
食品药品监管局	食品【藥】品監管局
可能出现的问题	可能【出】現的問題
发展的必然结果	【發】展的必然結果
多种因素的影响	多【種】因素的影響
最后一个交易日	最【後】一個交易日
国家烟草专卖局	國家【煙】草專賣局
得到了进一步的	得到【了】進一步的
的工作人员表示	的工作人員【表】示
刻骨铭心的回忆	刻骨銘心的【回】憶
计划生育委员会	計【劃】生育委員會
月亮代表我的心	月亮代【表】我的心
这是怎么回事呢	這是怎麼【回】事呢
经济社会的发展	經濟社會的【發】展
已经发生的事情	已經【發】生的事情
党的先进性建设	【黨】的先進性建設
当你爱上一个人	【當】你愛上一個人
与去年同期相比	與去年【同】期相比
人口与计划生育	人口與計【劃】生育
更加突出的位置	更加突【出】的位置
作出了重要贡献	作【出】【了】重要貢獻
房地产开发商的	房地產開【發】商的
中小企业的发展	中小企業的【發】展
按照科学发展观	按照科學【發】展觀
只是时间的问题	【只】是時間的問題
突飞猛进的发展	突飛猛進的【發】展
做出了重要贡献	做【出】【了】重要貢獻
到现在我才发现	到現在我【才】【發】現
不知道怎么回答	不知道怎麼【回】答
社会可持续发展	社會可持續【發】展
据台湾媒体报道	【據】【臺】灣媒體報道
股份制商业银行	股份【制】商業銀行
发展的战略地位	【發】展的戰略地位
国家主席胡锦涛	國家主席【胡】錦濤
计算机应用技术	計算機應用技【術】
不知道怎么回事	不知道怎麼【回】事
实现可持续发展	實現可持續【發】展
注册安全工程师	【注】冊安全工程師
科学技术委员会	科學技【術】委員會
阳光总在风雨后	陽光總在風雨【後】
保持党的先进性	保持【黨】的先進性
新的历史起点上	新的【歷】史起點上
西部大开发战略	西部大開【發】戰略
中国注册会计师	中國【注】冊會計師
高技术产业发展	高技【術】產業【發】展
党和国家领导人	【黨】和國家領導人
注册资产评估师	【注】冊資產評估師
丰富的旅游资源	【豐】富的旅【遊】資源
生命的最后一刻	生命的最【後】一刻
进销存管理系统	進銷存管理【係】統
这到底是怎么了	這到底是怎麼【了】
是什么原因导致	是什麼原因導【致】
中国共产党成立	中國共產【黨】成立
创造了有利条件	創造【了】有利條件
马克思主义理论	馬【克】思主義理論
我是一只小小鸟	我是一【只】小小鳥
的大型企业集团	的大型企業集【團】
中国青年出版社	中國青年【出】版社
基层党组织建设	基層【黨】組織建設
巴布亚新几内亚	巴【佈】亞新【幾】內亞
经济可持续发展	經濟可持續【發】展
新华社记者采访	新華社記者【採】訪
培养出来的学生	培養【出】來的學生
社会化服务体系	社會化服務體【係】
关系的重要组成	關【係】的重要組成
数据库管理系统	數【據】庫管理【係】統
征收个人所得税	【徵】收個人所得稅
胡锦涛总书记的	【胡】錦濤總書記的
自主研发的网络	自主研【發】的網絡
控制不住我自己	控【制】不住我自己
内蒙古呼和浩特	內【蒙】古呼和浩特
可持续发展能力	可持續【發】展能力
满城尽带黄金甲	滿城【盡】帶黃金甲
强烈的视觉冲击	強烈的視覺【衝】擊
社会科学出版社	社會科學【出】版社
奥林匹克运动会	奧林匹【克】運動會
中国可持续发展	中國可持續【發】展
彩色激光打印机	【彩】色激光打印機
中国美术家协会	中國美【術】家協會
共产党纪律处分	共產【黨】紀律處分
中国共产党党员	中國共產【黨】【黨】員
办公自动化系统	辦公自動化【係】統
多姿多彩的生活	多姿多【彩】的生活
经济发展的需要	經濟【發】展的需要
巨大的发展潜力	巨大的【發】展潛力
幸福快乐的生活	【幸】福快樂的生活
千呼万唤始出来	【千】呼【萬】喚始【出】來
在美国总统布什	在美國總統【佈】什
北京中医药大学	北京中醫【藥】大學
集团公司董事长	集【團】公司董事長
提出了更高要求	提【出】【了】更高要求
注册会计师协会	【注】冊會計師協會
中国网络游戏的	中國網絡【遊】戲的
经济体制改革的	經濟體【制】改革的
有时候也是一种	有時候也是一【種】
的调查数据显示	的調查數【據】顯示
你怎么不理我了	你怎麼不理我【了】
经济社会发展的	經濟社會【發】展的
管理体制改革的	管理體【制】改革的
山雨欲来风满楼	山雨【欲】來風滿樓
做出更大的贡献	做【出】更大的貢獻
农产品批发市场	農產品批【發】市場
有时候发现自己	有時候【發】現自己
武汉大学出版社	武漢大學【出】版社
作出了明确规定	作【出】【了】明確規定
达到了前所未有	達到【了】前所未有
受到了前所未有	受到【了】前所未有
中发挥重要作用	中【發】揮重要作用
不知道要干什么	不知道要【幹】什麼
不识庐山真面目	不識廬山真【面】目
我怎么不记得了	我怎麼不記得【了】
投资者重点关注	投資者重點關【注】
树立科学发展观	樹立科學【發】展觀
心有余而力不足	心有【餘】而力不足
民族的伟大复兴	民族的偉大【復】興
市场的供求关系	市場的供求關【係】
失去你我才知道	失去你我【才】知道
发生了什么事情	【發】生【了】什麼事情
体现科学发展观	體現科學【發】展觀
奠定了坚实基础	奠定【了】堅實基礎
转载请注明出处	轉載請【注】明【出】處
共同关心的问题	共【同】關心的問題
发挥更大的作用	【發】揮更大的作用
接受记者采访时	接受記者【採】訪時
集团首席执行官	集【團】首席執行官
新闻发布会宣布	新聞【發】【佈】會宣【佈】
保持党员先进性	保持【黨】員先進性
发展的关键时期	【發】展的關鍵時期
反不正当竞争法	反不正【當】競爭法
建立了合作关系	建立【了】合作關【係】
的一个重要方面	的一個重要方【面】
布宜诺斯艾利斯	【佈】宜諾斯艾利斯
良好的发展势头	良好的【發】展勢頭
柳暗花明又一村	柳【暗】花明又一村
税收征收管理法	稅收【徵】收管理法
复杂的系统工程	【復】雜的【係】統工程
中长期发展规划	中長期【發】展規【劃】
增值税专用发票	增值稅專用【發】票
面临的最大问题	【面】臨的最大問題
接受采访时表示	接受【採】訪時【表】示
房地产市场发展	房地產市場【發】展
只羡鸳鸯不羡仙	【只】羨鴛鴦不羨仙
是一项系统工程	是一項【係】統工程
安全生产责任制	安全生產責任【制】
坚持科学发展观	堅持科學【發】展觀
一江春水向东流	一江春水【向】東流
中国教育电视台	中國教育電視【臺】
不食人间烟火的	不食人間【煙】火的
有以下几个方面	有以下【幾】個方【面】
不正当竞争行为	不正【當】競爭行爲
我喜欢这种感觉	我喜歡這【種】感覺
最大的网络游戏	最大的網絡【遊】戲
在两周内速来电	在兩【周】內速來電
广州中医药大学	廣州中醫【藥】大學
为了进一步加强	爲【了】進一步加強
文化产业的发展	文化產業的【發】展
并不一定要拥有	【並】不一定要擁有
市场经济的发展	市場經濟的【發】展
抑制不住自己的	抑【制】不住自己的
房地产开发公司	房地產開【發】公司
罗密欧与朱丽叶	羅密歐與【朱】麗葉
无奈地摇了摇头	無奈地搖【了】搖頭
发展的必然要求	【發】展的必然要求
首当其冲的就是	首【當】其【衝】的就是
党路线方针政策	【黨】路線方【針】政策
在以下几个方面	在以下【幾】個方【面】
宁夏回族自治区	寧夏【回】族自治區
规范房地产市场	規【範】房地產市場
马克思主义政党	馬【克】思主義政【黨】
共产主义青年团	共產主義青年【團】
他现在怎么样了	他現在怎麼樣【了】
地区的经济发展	地區的經濟【發】展
比去年同期下降	比去年【同】期下降
不管发生什么事	不管【發】生什麼事
该出手时就出手	該【出】手時就【出】手
同是天涯沦落人	【同】是天涯淪落人
怎么舍得我难过	怎麼【舍】得我難過
经济欠发达地区	經濟欠【發】達地區
科学家研究发现	科學家研究【發】現
他忽然发现自己	他忽然【發】現自己
钢铁是怎样炼成	鋼鐵是怎樣【煉】成
服务器操作系统	服務器操作【係】統
梁山伯与祝英台	【樑】山伯與祝英【臺】
在美国纳斯达克	在美國納斯達【克】
云南省人民政府	【雲】南省人民政府
梦里花落知多少	夢【里】花落知多少
国际标准化组织	國際標【準】化組織
公司法定代表人	公司法定代【表】人
军委主席胡锦涛	軍委主席【胡】錦濤
在接受记者采访	在接受記者【採】訪
发生的事情太多	【發】生的事情太多
台湾事务办公室	【臺】灣事務辦公室
起到了重要作用	起到【了】重要作用
行政执法责任制	行政執法責任【制】
良好的人际关系	良好的人際關【係】
一切从实际出发	一切從實際【出】【發】
从一开始就注定	從一開始就【注】定
参加北京奥运会	【參】加北京奧運會
英国首相布莱尔	英國首相【佈】萊爾
据英国媒体报道	【據】英國媒體報道
有关部门了解到	有關部門【了】解到
与美国总统布什	與美國總統【佈】什
长江文艺出版社	長江文藝【出】版社
联产承包责任制	聯產承包責任【制】
上海古籍出版社	上海古籍【出】版社
你现在怎么样了	你現在怎麼樣【了】
北马里亚纳群岛	北馬【里】亞納群島
有关方面负责人	有關方【面】負責人
爱上了一个男孩	愛上【了】一個男孩
高新技术开发区	高新技【術】開【發】區
近水楼台先得月	近水樓【臺】先得月
存在的突出问题	存在的突【出】問題
实施西部大开发	實施西部大開【發】
师范大学出版社	師【範】大學【出】版社
自动化控制系统	自動化控【制】【係】統
进入了一个新的	進入【了】一個新的
发挥着重要作用	【發】揮著重要作用
发展现代服务业	【發】展現代服務業
高新技术产业化	高新技【術】產業化
面临着前所未有	【面】臨著前所未有
取得了举世瞩目	取得【了】舉世矚目
公布的数据显示	公【佈】的數【據】顯示
国民经济发展的	國民經濟【發】展的
建筑设计研究院	建【築】設計研究院
昌吉回族自治州	昌吉【回】族自治州
计算机集成制造	計算機集成【制】造
南京中医药大学	南京中醫【藥】大學
你知道我是谁了	你知道我是誰【了】
摩托罗拉对讲机	摩【托】羅拉對講機
发展的必然趋势	【發】展的必然趨勢
自治区党委书记	自治區【黨】委書記
可持续发展战略	可持續【發】展戰略
国家技术监督局	國家技【術】監督局
要以科学发展观	要以科學【發】展觀
石油天然气集团	石油天然氣集【團】
说了一遍又一遍	說【了】一遍又一遍
多囊卵巢综合征	多囊卵巢綜合【徵】
做出了不可磨灭	做【出】【了】不可磨滅
怎么又不说话了	怎麼又不說話【了】
在社会上引起了	在社會上引起【了】
强制性产品认证	強【制】性產品認證
每个人都有不同	每個人都有不【同】
商品房买卖合同	商品房買賣合【同】
国家发改委有关	國家【發】改委有關
坏蛋是怎样炼成	壞蛋是怎樣【煉】成
国家标准化管理	國家標【準】化管理
发表自己的看法	【發】【表】自己的看法
马克思主义基本	馬【克】思主義基本
丰富多彩的生活	【豐】富多【彩】的生活
取得了令人瞩目	取得【了】令人矚目
成都中医药大学	成都中醫【藥】大學
加入世贸组织后	加入世貿組織【後】
是我的大学同学	是我的大學【同】學
的网络游戏市场	的網絡【遊】戲市場
就完全不一样了	就完全不一樣【了】
最低工资标准的	最低工資標【準】的
哈尔滨师范大学	哈爾濱師【範】大學
电子科学与技术	電子科學與技【術】
提出了新的要求	提【出】【了】新的要求
经济的快速发展	經濟的快速【發】展
的基础上进行了	的基礎上進行【了】
准备的怎么样了	【準】備的怎麼樣【了】
完善的售后服务	完善的售【後】服務
创历史最高水平	創【歷】史最高水平
一千零一个愿望	一【千】零一個願望
经济的健康发展	經濟的健康【發】展
跟我有什么关系	跟我有什麼關【係】
下一代操作系统	下一代操作【係】統
原来你也在这里	原來你也在這【里】
八千里路云和月	八【千】【里】路【雲】和月
将要发生的事情	將要【發】生的事情
各种各样的问题	各【種】各樣的問題
各种各样的原因	各【種】各樣的原因
历史上规模最大	【歷】史上規模最大
你可以畅所欲言	你可以暢所【欲】言
丰富的胡萝卜素	【豐】富的【胡】蘿【卜】素
锲而不舍的精神	鍥而不【舍】的精神
经济发展水平和	經濟【發】展水平和
的专业技术人员	的專業技【術】人員
业内人士向记者	業內人士【向】記者
是不是我做错了	是不是我做錯【了】
记者采访时表示	記者【採】訪時【表】示
前所未有的发展	前所未有的【發】展
年中国网络游戏	年中國網絡【遊】戲
可以根据自己的	可以根【據】自己的
为了自己的利益	爲【了】自己的利益
可根据实际情况	可根【據】實際情況
是世界上最幸福	是世界上最【幸】福
也可以用另一种	也可以用另一【種】
一石激起千层浪	一石激起【千】層浪
技术性贸易壁垒	技【術】性貿易壁壘
中国经济的发展	中國經濟的【發】展
等非公有制经济	等非公有【制】經濟
做出了突出贡献	做【出】【了】突【出】貢獻
广东人民出版社	廣東人民【出】版社
千金散尽还复来	【千】金散【盡】還【復】來
从某种程度上说	從某【種】程度上說
社会发展的需要	社會【發】展的需要
安提瓜和巴布达	安提瓜和巴【佈】達
遇到了前所未有	遇到【了】前所未有
国民经济的发展	國民經濟的【發】展
什么都没有发生	什麼都沒有【發】生
人民日报出版社	人民日報【出】版社
新闻发言人表示	新聞【發】言人【表】示
春风文艺出版社	春風文藝【出】版社
发展的必由之路	【發】展的必由之路
转载请注明来源	轉載請【注】明來源
引起了轩然大波	引起【了】軒然大波
集团公司总经理	集【團】公司總經理
回到明朝当王爷	【回】到明朝【當】王爺
发展中国家提供	【發】展中國家提供
法兰克福车展上	法蘭【克】福車展上
上海中医药大学	上海中醫【藥】大學
牵一发而动全身	牽一【發】而動全身
已经有了很大的	已經有【了】很大的
进行房地产开发	進行房地產開【發】
良好的合作关系	良好的合作關【係】
广大发展中国家	廣大【發】展中國家
市场的健康发展	市場的健康【發】展
根据国家统计局	根【據】國家統計局
更大的发展空间	更大的【發】展空間
一些发展中国家	一些【發】展中國家
面临的主要问题	【面】臨的主要問題
到底是什么关系	到底是什麼關【係】
第十个五年计划	第十個五年計【劃】
贯彻科学发展观	貫徹科學【發】展觀
发现自己是多么	【發】現自己是多麼
我给你打电话了	我給你打電話【了】
谷歌拼音输入法	【谷】歌拼音輸入法
飞流直下三千尺	飛流直下三【千】尺
应注意以下几点	應【注】意以下【幾】點
抓获犯罪嫌疑人	抓【獲】犯罪嫌疑人
这样的事情发生	這樣的事情【發】生
据世界卫生组织	【據】世界衛生組織
系统性红斑狼疮	【係】統性紅斑狼瘡
艺术类本科专业	藝【術】類本科專業
工业与民用建筑	工業與民用建【築】
产业的快速发展	產業的快速【發】展
发生了重大变化	【發】生【了】重大變化
留下了深刻印象	留下【了】深刻印象
法国总统希拉克	法國總統希拉【克】
一系列优惠政策	一【係】列優惠政策
国家旅游局局长	國家旅【遊】局局長
房地产业的发展	房地產業的【發】展
生命里最重要的	生命【里】最重要的
几乎是不可能的	【幾】乎是不可能的
中国艺术研究院	中國藝【術】研究院
出现在我的生活	【出】現在我的生活
一场游戏一场梦	一場【遊】戲一場夢
原因是多方面的	原因是多方【面】的
作为发展中国家	作爲【發】展中國家
犹抱琵琶半遮面	猶抱琵琶半遮【面】
主要目的是为了	主要目的是爲【了】
我一个人在这里	我一個人在這【里】
也不知道怎么了	也不知道怎麼【了】
劳动合同法草案	勞動合【同】法草案
工作会议上了解	工作會議上【了】解
这种情况的原因	這【種】情況的原因
科学技术的发展	科學技【術】的【發】展
无论发生了什么	無論【發】生【了】什麼
之间的相互了解	之間的相互【了】解
各种各样的事情	各【種】各樣的事情
发展的重要因素	【發】展的重要因素
移动用户发送到	移動用戶【發】送到
塔克拉玛干沙漠	塔【克】拉瑪【幹】沙漠
让我们荡起双桨	讓我們【蕩】起雙槳
让我们共同努力	讓我們共【同】努力
发展的重大问题	【發】展的重大問題
的时候我才知道	的時候我【才】知道
从某种意义上说	從某【種】意義上說
这里的一切都是	這【里】的一切都是
社会的快速发展	社會的快速【發】展
中央电视台记者	中央電視【臺】記者
在今后一段时间	在今【後】一段時間
紧密联系在一起	緊密聯【係】在一起
中国证监会核准	中國證監會核【準】
提供了一个新的	提供【了】一個新的
电话采访时表示	電話【採】訪時【表】示
我真的不知道了	我真的不知道【了】
产业的健康发展	產業的健康【發】展
完全不同的生活	完全不【同】的生活
生命的最后时刻	生命的最【後】時刻
二氧化氯发生器	二氧化氯【發】生器
我只不过是一个	我【只】不過是一個
知道是怎么回事	知道是怎麼【回】事
你怎么不说话了	你怎麼不說話【了】
情人眼里出西施	情人眼【里】【出】西施
推进西部大开发	推進西部大開【發】
突发公共事件的	突【發】公共事件的
出现在我的生命	【出】現在我的生命
点这里把小游戏	點這【里】把小【遊】戲
究竟是怎么回事	究竟是怎麼【回】事
巨大的发展空间	巨大的【發】展空間
快速发展的同时	快速【發】展的【同】時
彩色喷墨打印机	【彩】色噴墨打印機
取得了圆满成功	取得【了】圓滿成功
国家发改委发布	國家【發】改委【發】【佈】
你是哪里的朋友	你是哪【里】的朋友
冬天里的一把火	【冬】天【里】的一把火
作出了重大贡献	作【出】【了】重大貢獻
只要你开心就好	【只】要你開心就好
新闻发布会现场	新聞【發】【佈】會現場
广阔的发展空间	廣闊的【發】展空間
中国证监会发布	中國證監會【發】【佈】
浪费了很多时间	浪費【了】很多時間
不知道是怎么了	不知道是怎麼【了】
一辈子都忘不了	一輩子都忘不【了】
解决了这个问题	解決【了】這個問題
控制性详细规划	控【制】性詳細規【劃】
不知道为了什么	不知道爲【了】什麼
已经有了自己的	已經有【了】自己的
知道自己的方向	知道自己的方【向】
起到了推波助澜	起到【了】推波助瀾
一发而不可收拾	一【發】而不可收拾
提高了工作效率	提高【了】工作效率
集团有限公司的	集【團】有限公司的
党和人民的事业	【黨】和人民的事業
国内市场占有率	國內市場【佔】有率
没有你的日子里	沒有你的日子【里】
的目的就是为了	的目的就是爲【了】
烟花三月下扬州	【煙】花三月下揚州
出现的一些问题	【出】現的一些問題
到底是为了什么	到底是爲【了】什麼
我以为我找到了	我以爲我找到【了】
可持续发展之路	可持續【發】展之路
什么时候回家的	什麼時候【回】家的
艰苦奋斗的精神	艱苦奮【鬭】的精神
发展才是硬道理	【發】展【才】是硬道理
都不知道干什么	都不知道【幹】什麼
离开了这个世界	離開【了】這個世界
新闻发布会上的	新聞【發】【佈】會上的
千丝万缕的联系	【千】絲【萬】縷的聯【係】
发达国家的经验	【發】達國家的經驗
东边日出西边雨	東邊日【出】西邊雨
万水千山总是情	【萬】水【千】山總是情
公司的数据显示	公司的數【據】顯示
蓝田日暖玉生烟	藍田日暖玉生【煙】
到底发生了什么	到底【發】生【了】什麼
免征个人所得税	免【徵】個人所得稅
内蒙古师范大学	內【蒙】古師【範】大學
计算机体系结构	計算機體【係】結構
吃饭睡觉干什么	吃飯睡覺【幹】什麼
自古英雄出少年	自古英雄【出】少年
那你现在在哪里	那你現在在哪【里】
一生爱你千百回	一生愛你【千】百【回】
共同努力的结果	共【同】努力的結果
公务员工资制度	公務員工資【制】度
广阔的发展前景	廣闊的【發】展前景
随时与我们联系	隨時與我們聯【係】
了不知道为什么	【了】不知道爲什麼
别的男人在一起	【別】的男人在一起
资本市场的发展	資本市場的【發】展
万里长城永不倒	【萬】【里】長城永不倒
突然出现了一个	突然【出】現【了】一個
执行新会计准则	執行新會計【準】則
教育事业的发展	教育事業的【發】展
人面不知何处去	人【面】不知何處去
法制工作委员会	法【制】工作委員會
发现自己怀孕了	【發】現自己懷孕【了】
奥林匹克运动的	奧林匹【克】運動的
因为我只是一个	因爲我【只】是一個
我不知道怎么了	我不知道怎麼【了】
加快发展服务业	加快【發】展服務業
的时间都没有了	的時間都沒有【了】
经济的不断发展	經濟的不斷【發】展
周围的每一个人	【周】圍的每一個人
注册商标专用权	【注】冊商標專用權
爱要怎么说出口	愛要怎麼說【出】口
表示衷心的感谢	【表】示衷心的感謝
这才是最重要的	這【才】是最重要的
石油输出国组织	石油輸【出】國組織
技术的不断发展	技【術】的不斷【發】展
只缘身在此山中	【只】緣身在此山中
在以胡锦涛同志	在以【胡】錦濤【同】【志】
进行了一系列的	進行【了】一【係】列的
公布的统计数据	公【佈】的統計數【據】
国务院领导同志	國務院領導【同】【志】
在全世界范围内	在全世界【範】圍內
社会的广泛关注	社會的廣泛關【注】
究竟是为了什么	究竟是爲【了】什麼
存贷款基准利率	存貸款基【準】利率
提供的数据显示	提供的數【據】顯示
什么也说不出来	什麼也說不【出】來
说不出来的滋味	說不【出】來的滋味
带来的负面影响	帶來的負【面】影響
自己的聪明才智	自己的聰明【才】智
谁动了我的奶酪	誰動【了】我的奶酪
各种各样的理由	各【種】各樣的理由
加拿大蒙特利尔	加拿大【蒙】特利爾
人类和平与发展	人類和平與【發】展
只是我一厢情愿	【只】是我一廂情願
振兴装备制造业	振興裝備【制】造業
另一方面也可以	另一方【面】也可以
稿件转载请注明	稿件轉載請【注】明
大学生志愿服务	大學生【志】願服務
我们之间的关系	我們之間的關【係】
湖北人民出版社	湖北人民【出】版社
现在怎么样了啊	現在怎麼樣【了】啊
西藏自治区党委	西藏自治區【黨】委
新闻发布会上说	新聞【發】【佈】會上說
商品房销售面积	商品房銷售【面】積
我怎么看不出来	我怎麼看不【出】來
事情发生的时候	事情【發】生的時候
中国进出口银行	中國進【出】口銀行
中国国民党主席	中國國民【黨】主席
北京大学中文系	北京大學中文【係】
发表自己的意见	【發】【表】自己的意見
的基础上增加了	的基礎上增加【了】
知道是为了什么	知道是爲【了】什麼
做出了巨大贡献	做【出】【了】巨大貢獻
信息请点击这里	信息請點擊這【里】
到现在我才知道	到現在我【才】知道
的一个重要标志	的一個重要標【志】
爱上了一个男人	愛上【了】一個男人
的时候我的心里	的時候我的心【里】
因为我发现自己	因爲我【發】現自己
进行了面对面的	進行【了】【面】對【面】的
的时候你会发现	的時候你會【發】現
怎么不说话了呢	怎麼不說話【了】呢
出现的每一个人	【出】現的每一個人
计划经济向市场	計【劃】經濟【向】市場
离开了我的世界	離開【了】我的世界
房地产开发建设	房地產開【發】建設
造成了不良影响	造成【了】不良影響
觉得自己很幸福	覺得自己很【幸】福
但并不是所有的	但【並】不是所有的
会一发不可收拾	會一【發】不可收拾
为什么不说话了	爲什麼不說話【了】
不知道怎么办了	不知道怎麼辦【了】
你一个人在那里	你一個人在那【里】
只是一个小小的	【只】是一個小小的
在这样的日子里	在這樣的日子【里】
出入境管理部门	【出】入境管理部門
公布的统计数字	公【佈】的統計數字
国际先驱论坛报	國際先驅論【壇】報
在中国网络游戏	在中國網絡【遊】戲
我怎么会在这里	我怎麼會在這【里】
同年同月同日生	【同】年【同】月【同】日生
经济的迅速发展	經濟的迅速【發】展
怎么不理我了啊	怎麼不理我【了】啊
历史上最大规模	【歷】史上最大規模
来到了这个世界	來到【了】這個世界
总是在我的心里	總是在我的心【里】
感到了前所未有	感到【了】前所未有
有什么事情发生	有什麼事情【發】生
操作系统的智能	操作【係】統的智能
体现了以人为本	體現【了】以人爲本
房地产投资信托	房地產投資信【托】
经济的高速发展	經濟的高速【發】展
经济发展不平衡	經濟【發】展不平衡
不知道怎么面对	不知道怎麼【面】對
经济的持续发展	經濟的持續【發】展
这个冬天不太冷	這個【冬】天不太冷
职业技术学院的	職業技【術】學院的
和我有什么关系	和我有什麼關【係】
家庭经济困难的	家庭經濟【困】難的
行业的健康发展	行業的健康【發】展
我的心里只有你	我的心【里】【只】有你
得到了社会各界	得到【了】社會各界
发改委主任马凯	【發】改委主任馬凱
大家的共同努力	大家的共【同】努力
电子商务的发展	電子商務的【發】展
各级党委和政府	各級【黨】委和政府
诺贝尔奖获得者	諾貝爾獎【獲】得者
一定的负面影响	一定的負【面】影響
别的女人在一起	【別】的女人在一起
出现在我的世界	【出】現在我的世界
要做好心理准备	要做好心理【準】備
问君能有几多愁	問君能有【幾】多愁
的方式有很多种	的方式有很多【種】
只是一个普通的	【只】是一個普通的
一定要注意安全	一定要【注】意安全
三个女人一台戏	三個女人一【臺】戲
住房公积金制度	住房公積金【制】度
中小企业板上市	中小企業【板】上市
表现得淋漓尽致	【表】現得淋【漓】【盡】【致】
怎么了不说话了	怎麼【了】不說話【了】
走进了我的生活	走進【了】我的生活
那我就不知道了	那我就不知道【了】
取得了巨大成就	取得【了】巨大成就
江山代有才人出	江山代有【才】人【出】
据有关部门统计	【據】有關部門統計
表达自己内心的	【表】達自己內心的
主要有以下几点	主要有以下【幾】點
出师未捷身先死	【出】師未捷身先死
上海文艺出版社	上海文藝【出】版社
做出了重大贡献	做【出】【了】重大貢獻
根据国家发改委	根【據】國家【發】改委
并不是我想要的	【並】不是我想要的
走进了我的世界	走進【了】我的世界
采取了一系列的	【採】取【了】一【係】列的
据香港媒体报道	【據】香港媒體報道
半个小时过去了	半個小時過去【了】
才是真正的生活	【才】是真正的生活
解决不了的问题	解決不【了】的問題
净利润同比增长	凈利潤【同】比增長
发现自己长大了	【發】現自己長大【了】
一蓑烟雨任平生	一蓑【煙】雨任平生
我不知道在哪里	我不知道在哪【里】
面不改色心不跳	【面】不改色心不跳
怎么不说话了啊	怎麼不說話【了】啊
互联网数据中心	互聯網數【據】中心
香格里拉大酒店	香格【里】拉大酒店
突发事件的能力	突【發】事件的能力
改变了我的生活	改變【了】我的生活
我不知道在那里	我不知道在那【里】
饮用水卫生标准	飲用水衛生標【準】
这又有什么关系	這又有什麼關【係】
抑制不住内心的	抑【制】不住內心的
空间技术研究院	空間技【術】研究院
就只有我一个人	就【只】有我一個人
计算机管理系统	計算機管理【係】統
丰富的自然资源	【豐】富的自然資源
是出于什么原因	是【出】於什麼原因
符拉迪沃斯托克	符拉迪沃斯【托】【克】
中国纺织品出口	中國紡織品【出】口
道不同不相为谋	道不【同】不相爲謀
临夏回族自治州	臨夏【回】族自治州
我怎么没看出来	我怎麼沒看【出】來
但由于种种原因	但由於【種】【種】原因
作出了巨大贡献	作【出】【了】巨大貢獻
长大了是第一次	長大【了】是第一次
马克思主义政治	馬【克】思主義政治
的一种生活方式	的一【種】生活方式
小商品批发市场	小商品批【發】市場
冲冠一怒为红颜	【衝】冠一怒爲紅顏
发行短期融资券	【發】行短期融資券
只是不知道怎么	【只】是不知道怎麼
引起了社会各界	引起【了】社會各界
同年同月同日死	【同】年【同】月【同】日死
国家统计局发布	國家統計局【發】【佈】
社会的和谐发展	社會的和諧【發】展
伊拉克战争爆发	伊拉【克】戰爭爆【發】
和你有什么关系	和你有什麼關【係】
宝剑锋从磨砺出	寶劍鋒從磨礪【出】
投资者关系管理	投資者關【係】管理
当我想你的时候	【當】我想你的時候
做好充分的准备	做好充分的【準】備
那里是做什么的	那【里】是做什麼的
我该怎么办才好	我該怎麼辦【才】好
提供了有利条件	提供【了】有利條件
到现在我才明白	到現在我【才】明白
只有在这个时候	【只】有在這個時候
怎么不认识我了	怎麼不認識我【了】
梦里不知身是客	夢【里】不知身是客
银行股份制改革	銀行股份【制】改革
认识了一个朋友	認識【了】一個朋友
一系列宏观调控	一【係】列宏觀調控
市场占有率达到	市場【佔】有率達到
征收土地增值税	【徵】收土地增值稅
却不知道当时的	卻不知道【當】時的
进出口贸易总额	進【出】口貿易總額
产品质量进行了	產品質量進行【了】
经历了那么多的	經【歷】【了】那麼多的
麦田里的守望者	麥田【里】的守望者
你有男朋友了吗	你有男朋友【了】嗎
发生什么事情了	【發】生什麼事情【了】
天生我才必有用	天生我【才】必有用
静静的坐在那里	靜靜的坐在那【里】
相当长一段时间	相【當】長一段時間
江苏省人民医院	江【蘇】省人民醫院
和谐的人际关系	和諧的人際關【係】
比利时布鲁塞尔	比利時【佈】魯塞爾
在这样的世界里	在這樣的世界【里】
我一定会回来的	我一定會【回】來的
发现自己真的是	【發】現自己真的是
巴西里约热内卢	巴西【里】約熱內盧
感觉到了自己的	感覺到【了】自己的
人面桃花相映红	人【面】桃花相映紅
充分的心理准备	充分的心理【準】備
留下了不可磨灭	留下【了】不可磨滅
只留下我一个人	【只】留下我一個人
香港贸易发展局	香港貿易【發】展局
经历了这么多的	經【歷】【了】這麼多的
根据信息产业部	根【據】信息產業部
中国证监会批准	中國證監會批【準】
例行新闻发布会	例行新聞【發】【佈】會
身无彩凤双飞翼	身無【彩】鳳雙飛翼
相见时难别亦难	相見時難【別】亦難
越来越多的证据	越來越多的證【據】
进行了大规模的	進行【了】大規模的
的最新数据显示	的最新數【據】顯示
二万五千里长征	二【萬】五【千】【里】長【徵】
未来的发展方向	未來的【發】展方【向】
文化产业发展的	文化產業【發】展的
解放军艺术学院	解放軍藝【術】學院
小灵通用户发送	小靈通用戶【發】送
变成了另外一个	變成【了】另外一個
社会主义公有制	社會主義公有【制】
很大的发展空间	很大的【發】展空間
发展可再生能源	【發】展可再生能源
工业自动化仪表	工業自動化儀【表】
经历了很多事情	經【歷】【了】很多事情
真的是最后一次	真的是最【後】一次
中央电视台报道	中央電視【臺】報道
学会了很多东西	學會【了】很多東西
但值得注意的是	但值得【注】意的是
进一步采取措施	進一步【採】取措施
为了自己的事业	爲【了】自己的事業
月最低工资标准	月最低工資標【準】
全额征收营业税	全額【徵】收營業稅
贫困家庭学生的	貧【困】家庭學生的
在你面前的时候	在你【面】前的時候
发展到一定程度	【發】展到一定程度
国家发改委宏观	國家【發】改委宏觀
强制性国家标准	強【制】性國家標【準】
改变了我的世界	改變【了】我的世界
静静地坐在那里	靜靜地坐在那【里】
中国体育代表团	中國體育代【表】【團】
在游戏的过程中	在【遊】戲的過程中
我实在受不了了	我實在受不【了】【了】
爱上你我不后悔	愛上你我不【後】悔
老夫聊发少年狂	老夫聊【發】少年狂
只是为了让自己	【只】是爲【了】讓自己
自然历史博物馆	自然【歷】史博物館
国家的经济发展	國家的經濟【發】展
不知道怎么表达	不知道怎麼【表】達
发展要有新思路	【發】展要有新思路
我的眼里只有你	我的眼【里】【只】有你
本报记者采访了	本報記者【採】訪【了】
长江后浪推前浪	長江【後】浪推前浪
去年同期增加了	去年【同】期增加【了】
足够的心理准备	足夠的心理【準】備
好久没看到你了	好久沒看到你【了】
我看到了自己的	我看到【了】自己的
我的眼睛湿润了	我的眼睛濕潤【了】
亚洲冬季运动会	亞洲【冬】季運動會
后天下之乐而乐	【後】天下之樂而樂
高校毕业生面向	高校畢業生【面】【向】
当前房地产市场	【當】前房地產市場
他们的联系电话	他們的聯【係】電話
可再生能源发展	可再生能源【發】展
奥林匹克体育场	奧林匹【克】體育場
国家发改委主任	國家【發】改委主任
其他发展中国家	其他【發】展中國家
中国人民志愿军	中國人民【志】願軍
党政机关办公楼	【黨】政機關辦公樓
回来给我打电话	【回】來給我打電話
进行了长时间的	進行【了】長時間的
全日制普通高校	全日【制】普通高校
改变了我的一生	改變【了】我的一生
遇到挫折的时候	遇到挫【折】的時候
造血干细胞移植	造血【幹】細胞移植
带来了前所未有	帶來【了】前所未有
复旦大学医学院	【復】旦大學醫學院
竞争中脱颖而出	競爭中脫穎而【出】
一个人走在回家	一個人走在【回】家
很多事情的发展	很多事情的【發】展
他们是为了避免	他們是爲【了】避免
国家计划委员会	國家計【劃】委員會
经济的飞速发展	經濟的飛速【發】展
一直都在我心里	一直都在我心【里】
汤加丽人体艺术	湯加麗人體藝【術】
就已经很不错了	就已經很不錯【了】
羊毛出在羊身上	羊毛【出】在羊身上
勿以恶小而为之	勿以【惡】小而爲之
怎么也睡不着了	怎麼也睡不著【了】
西方马克思主义	西方馬【克】思主義
有一天你会发现	有一天你會【發】現
回首向来萧瑟处	【回】首【向】來蕭瑟處
映日荷花别样红	映日荷花【別】樣紅
大风起兮云飞扬	大風起兮【雲】飛揚
有了长足的进步	有【了】長足的進步
开弓没有回头箭	開弓沒有【回】頭箭
生命的最后一天	生命的最【後】一天
未来的发展趋势	未來的【發】展趨勢
也不知道干什么	也不知道【幹】什麼
究竟发生了什么	究竟【發】生【了】什麼
长江中下游地区	長江中下【遊】地區
望帝春心托杜鹃	望帝春心【托】杜鵑
国家发改委经济	國家【發】改委經濟
工业控制计算机	工業控【制】計算機
燕雀安知鸿鹄志	燕雀安知鴻鵠【志】
春花秋月何时了	春花【秋】月何時【了】
不只是我一个人	不【只】是我一個人
政府新闻发言人	政府新聞【發】言人
立下了汗马功劳	立下【了】汗馬功勞
主要有三个方面	主要有三個方【面】
那我就没办法了	那我就沒辦法【了】
吸引了越来越多	吸引【了】越來越多
追求幸福的权利	追求【幸】福的權利
采蘑菇的小姑娘	【採】蘑菇的小姑【娘】
科学技术研究院	科學技【術】研究院
伊布拉希莫维奇	伊【佈】拉希莫維奇
签订了合作协议	【籖】訂【了】合作協議
世界和平与发展	世界和平與【發】展
下一张精彩图片	下一張精【彩】圖片
以后会发生什么	以【後】會【發】生什麼
再也不会回来了	再也不會【回】來【了】
集团新闻发言人	集【團】新聞【發】言人
山东人民出版社	山東人民【出】版社
带来了实实在在	帶來【了】實實在在
知道发生了什么	知道【發】生【了】什麼
任期目标责任制	任期目標責任【制】
一失足成千古恨	一失足成【千】古恨
故障恢复控制台	故障恢【復】控【制】【臺】
与以往不同的是	與以往不【同】的是
历年录取分数线	【歷】年錄取分數線
云想衣裳花想容	【雲】想衣裳花想容
梦游天姥吟留别	夢【遊】天姥吟留【別】
认识了很多朋友	認識【了】很多朋友
台湾同胞联谊会	【臺】灣【同】胞聯誼會
外交部发言人刘	外交部【發】言人劉
国家发改委公布	國家【發】改委公【佈】
安徽教育出版社	安徽教育【出】版社
新闻发言人制度	新聞【發】言人【制】度
上的利害关系人	上的利害關【係】人
你是我的幸福吗	你是我的【幸】福嗎
参拜靖国神社的	【參】拜靖國神社的
占国民生产总值	【佔】國民生產總值
后来的事实证明	【後】來的事實證明
出现在我的视野	【出】現在我的視野
岫岩满族自治县	岫【巖】滿族自治縣
千丝万缕的关系	【千】絲【萬】縷的關【係】
你的心里有我吗	你的心【里】有我嗎
我什么时候才能	我什麼時候【才】能
再见了最爱的人	再見【了】最愛的人
出现了一些问题	【出】現【了】一些問題
忍不住泪流满面	忍不住淚流滿【面】
让我们荡起双浆	讓我們【蕩】起雙漿
相关部门了解到	相關部門【了】解到
向天再借五百年	【向】天再【借】五百年
我终于失去了你	我終於失去【了】你
美国佛罗里达州	美國佛羅【里】達州
你什么时候回来	你什麼時候【回】來
又是一年过去了	又是一年過去【了】
联想集团副总裁	聯想集【團】副總裁
建设性合作关系	建設性合作關【係】
考试终于结束了	考試終於結束【了】
经历了一些事情	經【歷】【了】一些事情
眉毛胡子一把抓	眉毛【胡】子一把抓
工作会议上表示	工作會議上【表】示
承包经营责任制	承包經營責任【制】
都这么长时间了	都這麼長時間【了】
可再生能源发电	可再生能源【發】電
迷你小游戏下载	迷你小【遊】戲下載
香港旅游发展局	香港旅【遊】【發】展局
这并不是我想要	這【並】不是我想要
食品药品管理局	食品【藥】品管理局
越来越发现自己	越來越【發】現自己
中国农工民主党	中國農工民主【黨】
在主席台就座的	在主席【臺】就座的
子欲养而亲不在	子【欲】養而親不在
充分的思想准备	充分的思想【準】備
已经有了女朋友	已經有【了】女朋友
的情况时有发生	的情況時有【發】生
完成房地产开发	完成房地產開【發】
这是怎么一回事	這是怎麼一【回】事
布伦特原油期货	【佈】倫特原油期貨
多媒体信息系统	多媒體信息【係】統
帮助发展中国家	幫助【發】展中國家
这样才能让自己	這樣【才】能讓自己
爱一个人要了解	愛一個人要【了】解
土地出让净收益	土地【出】讓凈收益
直到现在才发现	直到現在【才】【發】現
外国投资者并购	外國投資者【並】購
千树万树梨花开	【千】樹【萬】樹梨花開
起到了关键作用	起到【了】關鍵作用
双方的共同努力	雙方的共【同】努力
在我心里的位置	在我心【里】的位置
冤冤相报何时了	冤冤相報何時【了】
我们这里还有鱼	我們這【里】還有魚
计算机监控系统	計算機監控【係】統
密不可分的关系	密不可分的關【係】
越来越喜欢你了	越來越喜歡你【了】
外交部发言人秦	外交部【發】言人秦
中国国家旅游局	中國國家旅【遊】局
如果再回到从前	如果再【回】到從前
上演了帽子戏法	上演【了】帽子戲法
银行体系流动性	銀行體【係】流動性
台北市长马英九	【臺】北市長馬英九
法院审理后认为	法院審理【後】認爲
力所能及的范围	力所能及的【範】圍
起到了至关重要	起到【了】至關重要
我还以为你走了	我還以爲你走【了】
党的先进性教育	【黨】的先進性教育
一名出租车司机	一名【出】租車司機
我到了这个时候	我到【了】這個時候
人类基因组计划	人類基因組計【劃】
丰宁满族自治县	【豐】寧滿族自治縣
多用户操作系统	多用戶操作【係】統
在西方发达国家	在西方【發】達國家
直挂云帆济沧海	直掛【雲】帆濟滄海
那我就不清楚了	那我就不清楚【了】
与尔同销万古愁	與爾【同】銷【萬】古愁
风云榜颁奖盛典	風【雲】榜頒獎盛典
幸福其实很简单	【幸】福其實很簡單
新的一年开始了	新的一年開始【了】
出现了前所未有	【出】現【了】前所未有
汽车工业的发展	汽車工業的【發】展
中国青年志愿者	中國青年【志】願者
资本市场发展的	資本市場【發】展的
除却巫山不是云	除卻巫山不是【雲】
只要为你活一天	【只】要爲你活一天
采取不正当手段	【採】取不正【當】手段
命里无时莫强求	命【里】無時莫強求
主要有两个方面	主要有兩個方【面】
生活水平提高了	生活水平提高【了】
慢慢的喜欢上了	慢慢的喜歡上【了】
世界粮食计划署	世界糧食計【劃】署
进行了问卷调查	進行【了】問【捲】調查
建筑材料工业局	建【築】材料工業局
亲爱的你在哪里	親愛的你在哪【里】
一将功成万骨枯	一將功成【萬】骨枯
与往年不同的是	與往年不【同】的是
树欲静而风不止	樹【欲】靜而風不止
一定要比我幸福	一定要比我【幸】福
刺痛了我的眼睛	刺痛【了】我的眼睛
是一个人的精彩	是一個人的精【彩】
但愿人长久千里	但願人長久【千】【里】
世界上只有一个	世界上【只】有一個
乱花渐欲迷人眼	亂花漸【欲】迷人眼
儿行千里母担忧	兒行【千】【里】母擔憂
你什么时候回家	你什麼時候【回】家
工程开发总公司	工程開【發】總公司
蜡炬成灰泪始干	【蠟】炬成灰淚始【幹】
你是干什么的呀	你是【幹】什麼的呀
人生得意须尽欢	人生得意【須】【盡】歡
计划经济时代的	計【劃】經濟時代的
广泛的共同利益	廣泛的共【同】利益
媒体关注的焦点	媒體關【注】的焦點
电热鼓风干燥箱	電熱鼓風【幹】燥箱
姑苏城外寒山寺	姑【蘇】城外寒山寺
出席新闻发布会	【出】席新聞【發】【佈】會
经济适用房制度	經濟適用房【制】度
夏商周断代工程	夏商【周】斷代工程
解铃还需系铃人	解鈴還需【係】鈴人
这也是一种幸福	這也是一【種】【幸】福
这是怎么回事啊	這是怎麼【回】事啊
引起了广泛关注	引起【了】廣泛關【注】
已经有了男朋友	已經有【了】男朋友
不说了还不行吗	不說【了】還不行嗎
从实际情况出发	從實際情況【出】【發】
部分地区出现了	部分地區【出】現【了】
小荷才露尖尖角	小荷【才】露尖尖角
怎么不说话了呀	怎麼不說話【了】呀
期待的网络游戏	期待的網絡【遊】戲
轻舟已过万重山	輕舟已過【萬】重山
根据中国证监会	根【據】中國證監會
外交部发言人姜	外交部【發】言人【薑】
一位出租车司机	一位【出】租車司機
乌兹别克斯坦队	烏茲【別】【克】斯坦隊
放之四海而皆准	放之四海而皆【準】
不正当交易行为	不正【當】交易行爲
据国家税务总局	【據】國家稅務總局
赔了夫人又折兵	賠【了】夫人又【折】兵
什么时候回来的	什麼時候【回】來的
台湾同胞在内的	【臺】灣【同】胞在內的
向大家介绍一下	【向】大家介紹一下
为了让更多的人	爲【了】讓更多的人
春蚕到死丝方尽	春蠶到死絲方【盡】
只有在夜深人静	【只】有在夜深人靜
出版工作者协会	【出】版工作者協會
今年春节黄金周	今年春節黃金【周】
创历史最高纪录	創【歷】史最高紀錄
中央党史研究室	中央【黨】史研究室
国家发改委价格	國家【發】改委價格
俄罗斯经济发展	俄羅斯經濟【發】展
只想一生跟你走	【只】想一生跟你走
达摩克利斯之剑	達摩【克】利斯之劍
恐龙特急克塞号	恐龍特急【克】塞號
太阳升起的地方	太陽【升】起的地方
一天一天过去了	一天一天過去【了】
此曲只应天上有	此【曲】【只】應天上有
家庭版操作系统	家庭版操作【係】統
面朝黄土背朝天	【面】朝黃土背朝天
我什么都给你了	我什麼都給你【了】
多情自古伤离别	多情自古傷離【別】
生物制品研究所	生物【制】品研究所
的时候千万不要	的時候【千】【萬】不要
奥林匹克委员会	奧林匹【克】委員會
众里寻他千百度	眾【里】尋他【千】百度
只想和你在一起	【只】想和你在一起
另一方面也说明	另一方【面】也說明
联通用户发送到	聯通用戶【發】送到
离开你我才发现	離開你我【才】【發】現
我是真的爱上了	我是真的愛上【了】
国家医药管理局	國家醫【藥】管理局
新的一年又到了	新的一年又到【了】
牵引力控制系统	牽引力控【制】【係】統
激励与约束机制	激勵與約束機【制】
置之死地而后生	置之死地而【後】生
进出口食品安全	進【出】口食品安全
直到现在才明白	直到現在【才】明白
千载难逢的机会	【千】載難逢的機會
几家欢乐几家愁	【幾】家歡樂【幾】家愁
什么时候才能不	什麼時候【才】能不
意大利文艺复兴	意大利文藝【復】興
天光云影共徘徊	天光【雲】影共徘徊
日出江花红胜火	日【出】江花紅勝火
我才发现原来我	我【才】【發】現原來我
机关算尽太聪明	機關算【盡】太聰明
北京市人大代表	北京市人大代【表】
取得了巨大成功	取得【了】巨大成功
富士康科技集团	富士康科技集【團】
参加中央电视台	【參】加中央電視【臺】
参加新闻发布会	【參】加新聞【發】【佈】會
回眸一笑百媚生	【回】眸一笑百媚生
在计划经济时代	在計【劃】經濟時代
红藕香残玉簟秋	紅藕香殘玉簟【秋】
掀起了轩然大波	掀起【了】軒然大波
记得当时年纪小	記得【當】時年紀小
万绿丛中一点红	【萬】綠叢中一點紅
的目的只有一个	的目的【只】有一個
你叫什么名字了	你叫什麼名字【了】
中国戏剧出版社	中國戲劇【出】版社
提出了殷切希望	提【出】【了】殷切希望
不过话又说回来	不過話又說【回】來
面向二十一世纪	【面】【向】二十一世紀
聚合酶链式反应	聚合酶【鏈】式反應
工作人员向记者	工作人員【向】記者
公布的报告显示	公【佈】的報告顯示
好男儿志在四方	好男兒【志】在四方
国家发改委能源	國家【發】改委能源
赋得古原草送别	賦得古原草送【別】
海淀区人民法院	海【澱】區人民法院
的事件时有发生	的事件時有【發】生
许多发展中国家	許多【發】展中國家
更值得注意的是	更值得【注】意的是
众所周知的原因	眾所【周】知的原因
山重水复疑无路	山重水【復】疑無路
在社会上造成了	在社會上造成【了】
投资者注意风险	投資者【注】意風險
不带走一片云彩	不帶走一片【雲】【彩】
涡轮增压发动机	渦輪增壓【發】動機
大学中文系教授	大學中文【係】教授
他们之间的关系	他們之間的關【係】
得到了前所未有	得到【了】前所未有
这段感情失败后	這段感情失敗【後】
很大的负面影响	很大的負【面】影響
口腔颌面外科学	口腔頜【面】外科學
去年同期上升了	去年【同】期上【升】【了】
台湾地区领导人	【臺】灣地區領導人
西班牙当地时间	西班牙【當】地時間
军工企业股份制	軍工企業股份【制】
基础性制度建设	基礎性【制】度建設
已经一去不复返	已經一去不【復】返
弹出菜单中选择	彈【出】菜單中選擇
沉舟侧畔千帆过	沉舟側畔【千】帆過
已经有了一定的	已經有【了】一定的
古来征战几人回	古來【徵】戰【幾】人【回】
只是当时已惘然	【只】是【當】時已惘然
的同时在线人数	的【同】時在線人數
操作系统处理器	操作【係】統處理器
中央气象台今天	中央氣象【臺】今天
不尽长江滚滚来	不【盡】長江滾滾來
红星照我去战斗	紅星照我去戰【鬭】
最后一场小组赛	最【後】一場小組賽
发布会上了解到	【發】【佈】會上【了】解到
恶劣的社会影响	【惡】劣的社會影響
好久没看见你了	好久沒看見你【了】
这段时间发生了	這段時間【發】生【了】
宰相肚里能撑船	宰相肚【里】能撐船
奥林匹克文化节	奧林匹【克】文化節
我只能告诉自己	我【只】能告訴自己
你现在才知道啊	你現在【才】知道啊
福布斯中国富豪	福【佈】斯中國富豪
约翰克利斯朵夫	約翰【克】利斯朵夫
别时容易见时难	【別】時容易見時難
表现的淋漓尽致	【表】現的淋【漓】【盡】【致】
万紫千红总是春	【萬】紫【千】紅總是春
苏格兰皇家银行	【蘇】格蘭皇家銀行
美国总统克林顿	美國總統【克】林頓
犯罪嫌疑人抓获	犯罪嫌疑人抓【獲】
次参拜靖国神社	次【參】拜靖國神社
进行了批评教育	進行【了】批評教育
解铃还须系铃人	解鈴還【須】【係】鈴人
每个人只有一次	每個人【只】有一次
并不能从根本上	【並】不能從根本上
我该怎么去面对	我該怎麼去【面】對
的目的不是为了	的目的不是爲【了】
爱丽丝梦游仙境	愛麗絲夢【遊】仙境
怎一个爽字了得	怎一個爽字【了】得
国家发改委日前	國家【發】改委日前
八一电影制片厂	八一電影【制】片廠
相声表演艺术家	相聲【表】演藝【術】家
获得中国证监会	【獲】得中國證監會
问题的症结所在	問題的【症】結所在
中央革命根据地	中央革命根【據】地
据有关人士透露	【據】有關人士透露
爱在心里口难开	愛在心【里】口難開
维也纳爱乐乐团	維也納愛樂樂【團】
跨越式发展战略	跨越式【發】展戰略
扩大农产品出口	擴大農產品【出】口
在北京师范大学	在北京師【範】大學
提供了可乘之机	提供【了】可乘之機
于美国当地时间	於美國【當】地時間
和平发展的道路	和平【發】展的道路
一系列社会问题	一【係】列社會問題
两国关系的发展	兩國關【係】的【發】展
改变了我的人生	改變【了】我的人生
在同一个城市里	在【同】一個城市【里】
奥林匹克大家庭	奧林匹【克】大家庭
都发生在我身上	都【發】生在我身上
中国科学技术馆	中國科學技【術】館
表达自己的意见	【表】達自己的意見
中国烟草总公司	中國【煙】草總公司
不为五斗米折腰	不爲五【鬭】米【折】腰
中央气象台预报	中央氣象【臺】預報
射频同轴连接器	射頻【同】軸連接器
为了实现自己的	爲【了】實現自己的
据俄罗斯新闻网	【據】俄羅斯新聞網
那一天你会发现	那一天你會【發】現
上梁不正下梁歪	上【樑】不正下【樑】歪
公布的数字显示	公【佈】的數字顯示
云中谁寄锦书来	【雲】中誰寄錦書來
只是你在我身边	【只】是你在我身邊
你们还是保持了	你們還是保持【了】
新一代操作系统	新一代操作【係】統
思念总在分手后	思念總在分手【後】
我只爱你一个人	我【只】愛你一個人
并不代表我快乐	【並】不代【表】我快樂
好了不和你说了	好【了】不和你說【了】
千里姻缘一线牵	【千】【里】姻緣一線牽
股权分置改革后	股權分置改革【後】
向联合国安理会	【向】聯合國安理會
岁岁年年人不同	歲歲年年人不【同】
范布隆克霍斯特	【範】【佈】隆【克】霍斯特
国民党荣誉主席	國民【黨】榮譽主席
下一页发表评论	下一頁【發】【表】評論
胡锦涛主席访问	【胡】錦濤主席訪問
良药苦口利于病	良【藥】苦口利於病
看看外面的世界	看看外【面】的世界
好久不见你了啊	好久不見你【了】啊
国际事务中发挥	國際事務中【發】揮
出现频率最高的	【出】現頻率最高的
计算机辅助制造	計算機輔助【制】造
的时候发现自己	的時候【發】現自己
乱红飞过秋千去	亂紅飛過【秋】【千】去
春有百花秋有月	春有百花【秋】有月
形成了鲜明对比	形成【了】鮮明對比
中国国家发改委	中國國家【發】改委
你现在在哪里呢	你現在在哪【里】呢
脑子里一片空白	腦子【里】一片空白
腾讯计算机系统	騰訊計算機【係】統
长效口服避孕药	長效口服避孕【藥】
那我不打扰你了	那我不打擾你【了】
忘了你我做不到	忘【了】你我做不到
捐献造血干细胞	捐獻造血【幹】細胞
检察院批准逮捕	檢察院批【準】逮捕
发动伊拉克战争	【發】動伊拉【克】戰爭
据英国广播公司	【據】英國廣播公司
有关人士向记者	有關人士【向】記者
知人知面不知心	知人知【面】不知心
可持续发展基金	可持續【發】展基金
获得奥斯卡最佳	【獲】得奧斯卡最佳
后宫佳丽三千人	【後】宮佳麗三【千】人
什么时候回来呀	什麼時候【回】來呀
已得到有效控制	已得到有效控【制】
不拘一格降人才	不拘一格降人【才】
你不是看到了吗	你不是看到【了】嗎
奥林匹克精神的	奧林匹【克】精神的
一曲新词酒一杯	一【曲】新詞酒一杯
明朝散发弄扁舟	明朝散【發】弄扁舟
无法控制自己的	無法控【制】自己的
拒人于千里之外	拒人於【千】【里】之外
复杂的人际关系	【復】雜的人際關【係】
有关方面了解到	有關方【面】【了】解到
并不是我想象的	【並】不是我想象的
当男人爱上女人	【當】男人愛上女人
根据需要和可能	根【據】需要和可能
错综复杂的关系	錯綜【復】雜的關【係】
表现不尽如人意	【表】現不【盡】如人意
梅里斯达斡尔族	梅【里】斯達斡爾族
欧洲经济共同体	歐洲經濟共【同】體
贸易代表办公室	貿易代【表】辦公室
拜科努尔发射场	拜科努爾【發】射場
错综复杂的剧情	錯綜【復】雜的劇情
和乌兹别克斯坦	和烏茲【別】【克】斯坦
美术电影制片厂	美【術】電影【制】片廠
在乌兹别克斯坦	在烏茲【別】【克】斯坦
好久没有上网了	好久沒有上網【了】
伊拉克安全部队	伊拉【克】安全部隊
多媒体光盘制作	多媒體光盤【制】作
你现在在哪里啊	你現在在哪【里】啊
远近高低各不同	遠近高低各不【同】
普通高校艺术类	普通高校藝【術】類
大厂回族自治县	大廠【回】族自治縣
进行了现场直播	進行【了】現場直播
负责人明确表示	負責人明確【表】示
现在的我忘记了	現在的我忘記【了】
非线性控制系统	非線性控【制】【係】統
为了满足自己的	爲【了】滿足自己的
同美国总统布什	【同】美國總統【佈】什
管不了那么多了	管不【了】那麼多【了】
什么也没有发生	什麼也沒有【發】生
动态链接库文件	動態【鏈】接庫文件
在双方共同努力	在雙方共【同】努力
游戏机实用技术	【遊】戲機實用技【術】
识时务者为俊杰	識時務者爲俊【傑】
一枝红杏出墙来	一枝紅杏【出】牆來
横眉冷对千夫指	橫眉冷對【千】夫指
新的一年又来了	新的一年又來【了】
维护发展中国家	維護【發】展中國家
记者采访了解到	記者【採】訪【了】解到
万丈高楼平地起	【萬】丈高樓平地起
并没有想象中的	【並】沒有想象中的
共计折合人民币	共計【折】合人民幣
为什么会有这种	爲什麼會有這【種】
凤凰台上忆吹箫	鳳凰【臺】上憶吹簫
提供的数据表明	提供的數【據】【表】明
太阳从西边出来	太陽從西邊【出】來
确定了恋爱关系	確定【了】戀愛關【係】
提供了这样一个	提供【了】這樣一個
吃亏就是占便宜	吃虧就是【佔】便宜
一个萝卜一个坑	一個蘿【卜】一個坑
宣布无条件投降	宣【佈】無條件投降
奔流到海不复回	奔流到海不【復】【回】
找不到回家的路	找不到【回】家的路
因为工作的关系	因爲工作的關【係】
引人注目的就是	引人【注】目的就是
经历过风风雨雨	經【歷】過風風雨雨
叱咤乐坛流行榜	叱吒樂【壇】流行榜
酒逢知己千杯少	酒逢知己【千】杯少
了股权分置改革	【了】股權分置改革
日参拜靖国神社	日【參】拜靖國神社
美国总统尼克松	美國總統尼【克】【鬆】
我再也不理你了	我再也不理你【了】
只有和你在一起	【只】有和你在一起
病树前头万木春	病樹前頭【萬】木春
因为你在我心里	因爲你在我心【里】
这个世界上只有	這個世界上【只】有
生命中的第几个	生命中的第【幾】個
台湾当局领导人	【臺】灣【當】局領導人
表现得非常优秀	【表】現得非常優秀
赢得青楼薄幸名	贏得青樓薄【幸】名
伊拉克武装人员	伊拉【克】武裝人員
客户端下载链接	客戶端下載【鏈】接
青出于蓝胜于蓝	青【出】於藍勝於藍
召开了紧急会议	召開【了】緊急會議
莫待无花空折枝	莫待無花空【折】枝
另一种生活方式	另一【種】生活方式
我是真的受伤了	我是真的受傷【了】
白发人送黑发人	白【發】人送黑【發】人
据香港星岛日报	【據】香港星島日報
西出阳关无故人	西【出】陽關無故人
理所当然的事情	理所【當】然的事情
创历史最高记录	創【歷】史最高記錄
人怕出名猪怕壮	人怕【出】名豬怕壯
孟村回族自治县	孟村【回】族自治縣
上海中心气象台	上海中心氣象【臺】
证实了这一消息	證實【了】這一消息
我才知道要珍惜	我【才】知道要珍惜
黑云压城城欲摧	黑【雲】壓城城【欲】摧
公司的法人代表	公司的法人代【表】
松桃苗族自治县	【鬆】桃苗族自治縣
在前面说了什么	在前【面】說【了】什麼
桃花潭水深千尺	桃花潭水深【千】尺
时间长了就好了	時間長【了】就好【了】
无党派民主人士	無【黨】派民主人士
两岸关系发展的	兩岸關【係】【發】展的
你现在干什么呢	你現在【幹】什麼呢
淋漓尽致不痛快	淋【漓】【盡】【致】不痛快
医学衷中参西录	醫學衷中【參】西錄
不是已经拿到了	不是已經拿到【了】
沉迷于网络游戏	沉迷於網絡【遊】戲
女子无才便是德	女子無【才】便是德
现在都得到幸福	現在都得到【幸】福
一块石头落了地	一塊石頭落【了】地
幸福美满的生活	【幸】福美滿的生活
向世界贸易组织	【向】世界貿易組織
拔出萝卜带出泥	拔【出】蘿【卜】帶【出】泥
完全不同的世界	完全不【同】的世界
最大的不同之处	最大的不【同】之處
无以复加的地步	無以【復】加的地步
马上就要开始了	馬上就要開始【了】
网络出版管理司	網絡【出】版管理司
在博鳌亚洲论坛	在博鰲亞洲論【壇】
也是一种很好的	也是一【種】很好的
万里长征人未还	【萬】【里】長【徵】人未還
解决不了问题的	解決不【了】問題的
东风夜放花千树	東風夜放花【千】樹
不能控制自己的	不能控【制】自己的
得了便宜还卖乖	得【了】便宜還賣乖
在伊拉克遭绑架	在伊拉【克】遭綁架
最终还是选择了	最終還是選擇【了】
新闻出版总署等	新聞【出】版總署等
发放录取通知书	【發】放錄取通知書
乌兹别克斯坦的	烏茲【別】【克】斯坦的
双方的共同利益	雙方的共【同】利益
参加高考的学生	【參】加高考的學生
就什么都没有了	就什麼都沒有【了】
只在乎曾经拥有	【只】在乎曾經擁有
两国人民带来了	兩國人民帶來【了】
好长时间没见了	好長時間沒見【了】
据中国人民银行	【據】中國人民銀行
苏格兰格拉斯哥	【蘇】格蘭格拉斯哥
网络游戏运营商	網絡【遊】戲運營商
行百里者半九十	行百【里】者半九十
煤炭可持续发展	煤炭可持續【發】展
什么时候回学校	什麼時候【回】學校
香巴拉并不遥远	香巴拉【並】不遙遠
人类胚胎干细胞	人類胚胎【幹】細胞
我死了你怎么办	我死【了】你怎麼辦
暗香浮动月黄昏	【暗】香浮動月黃昏
为有牺牲多壮志	爲有犧牲多壯【志】
可能发生的事情	可能【發】生的事情
才是真正的爱情	【才】是真正的愛情
不打无准备之仗	不打無【準】備之仗
哈萨克斯坦总统	哈薩【克】斯坦總統
投资者密切关注	投資者密切關【注】
白日放歌须纵酒	白日放歌【須】縱酒
有点不好意思了	有點不好意思【了】
只剩下我一个人	【只】剩下我一個人
银烛秋光冷画屏	銀燭【秋】光冷畫屏
守得云开见月明	守得【雲】開見月明
专稿转载请注明	專稿轉載請【注】明
命里有时终须有	命【里】有時終【須】有
两国关系发展的	兩國關【係】【發】展的
你已经不能控制	你已經不能控【制】
好久没有见你了	好久沒有見你【了】
出淤泥而不染的	【出】淤泥而不染的
春风送暖入屠苏	春風送暖入屠【蘇】
在伊拉克战争中	在伊拉【克】戰爭中
氧氟沙星注射液	氧氟沙星【注】射液
天长地久有时尽	天長地久有時【盡】
的大部分时间里	的大部分時間【里】
春宵一刻值千金	春宵一刻值【千】金
天然气出厂价格	天然氣【出】廠價格
孤帆远影碧空尽	孤帆遠影碧空【盡】
在这个物欲横流	在這個物【欲】橫流
置之死地而后快	置之死地而【後】快
小灵通彩铃下载	小靈通【彩】鈴下載
一哭二闹三上吊	一哭二鬧三上【吊】
自己的幸福生活	自己的【幸】福生活
远程数据库访问	遠程數【據】庫訪問
山穷水尽疑无路	山窮水【盡】疑無路
全员劳动合同制	全員勞動合【同】【制】
顾不了那么多了	顧不【了】那麼多【了】
拣尽寒枝不肯栖	揀【盡】寒枝不肯棲
出现了越来越多	【出】現【了】越來越多
技术含量都没有	技【術】含量都沒有
万古云霄一羽毛	【萬】古【雲】霄一羽毛
师夷长技以制夷	師夷長技以【制】夷
赢得生前身后名	贏得生前身【後】名
什么时候回去的	什麼時候【回】去的
胚胎干细胞研究	胚胎【幹】細胞研究
寥廓江天万里霜	寥廓江天【萬】【里】霜
据台湾东森新闻	【據】【臺】灣東森新聞
死要面子活受罪	死要【面】子活受罪
收拾得干干净净	收拾得【幹】【幹】凈凈
控制不了自己的	控【制】不【了】自己的
两岸关系的发展	兩岸關【係】的【發】展
我们第一次见面	我們第一次見【面】
再也没有出现过	再也沒有【出】現過
不知道说什么了	不知道說什麼【了】
只是个时间问题	【只】是個時間問題
计算机硬件系统	計算機硬件【係】統
柔肠一寸愁千缕	柔腸一寸愁【千】縷
大水冲了龙王庙	大水【衝】【了】龍王廟
什么时候回家啊	什麼時候【回】家啊
专利和技术转让	專利和技【術】轉讓
欲与天公试比高	【欲】與天公試比高
是不可能发生的	是不可能【發】生的
复制到当前位置	【復】【制】到【當】前位置
好心当成驴肝肺	好心【當】成驢肝肺
点点滴滴的回忆	點點滴滴的【回】憶
反对伊拉克战争	反對伊拉【克】戰爭
浪子回头金不换	浪子【回】頭金不換
寂寞空庭春欲晚	寂寞空庭春【欲】晚
迎来了新的一年	迎來【了】新的一年
非常困难的事情	非常【困】難的事情
计划没有变化快	計【劃】沒有變化快
没有足够的证据	沒有足夠的證【據】
更能消几番风雨	更能消【幾】番風雨
就一发不可收拾	就一【發】不可收拾
克里斯蒂拍卖行	【克】【里】斯蒂拍賣行
我的心里好难受	我的心【里】好難受
复合硅酸盐水泥	【復】合硅酸鹽水泥
少年壮志不言愁	少年壯【志】不言愁
美国白宫发言人	美國白宮【發】言人
小组赛最后一场	小組賽最【後】一場
五彩缤纷的世界	五【彩】繽紛的世界
同一条起跑线上	【同】一條起跑線上
明白发生了什么	明白【發】生【了】什麼
路上行人欲断魂	路上行人【欲】斷魂
醉里吴音相媚好	醉【里】吳音相媚好
题破山寺后禅院	題破山寺【後】禪院
伊拉克临时政府	伊拉【克】臨時政府
小心驶得万年船	小心駛得【萬】年船
发现自己越来越	【發】現自己越來越
社会集团购买力	社會集【團】購買力
高等学校艺术类	高等學校藝【術】類
窗含西岭千秋雪	窗含西嶺【千】【秋】雪
最终还是离开了	最終還是離開【了】
总参谋长梁光烈	總【參】謀長【樑】光烈
你会不会舍不得	你會不會【舍】不得
网络游戏市场的	網絡【遊】戲市場的
经历了风风雨雨	經【歷】【了】風風雨雨
呼儿将出换美酒	呼兒將【出】換美酒
增加发展中国家	增加【發】展中國家
中国铁路文工团	中國鐵路文工【團】
在我心里的地位	在我心【里】的地位
鄂温克族自治旗	鄂溫【克】族自治旗
几乎在同一时间	【幾】乎在【同】一時間
家庭承包责任制	家庭承包責任【制】
哈萨克斯坦石油	哈薩【克】斯坦石油
少小离家老大回	少小離家老大【回】
我都不好意思了	我都不好意思【了】
相差十万八千里	相差十【萬】八【千】【里】
公布的游戏画面	公【佈】的【遊】戲畫【面】
发展到什么程度	【發】展到什麼程度
纤维蛋白溶解酶	【纖】維蛋白溶解酶
伊拉克特别法庭	伊拉【克】特【別】法庭
发生了很多事情	【發】生【了】很多事情
她现在怎么样了	她現在怎麼樣【了】
粪土当年万户侯	糞土【當】年【萬】戶侯
不是同一个世界	不是【同】一個世界
你不相信就算了	你不相信就算【了】
涡轮喷气发动机	渦輪噴氣【發】動機
负责人昨天表示	負責人昨天【表】示
伊拉克战争以来	伊拉【克】戰爭以來
回首往事的时候	【回】首往事的時候
胰蛋白酶抑制剂	胰蛋白酶抑【制】劑
的生命只有一次	的生命【只】有一次
移动到当前位置	移動到【當】前位置
考生在填报志愿	考生在填報【志】願
我实在忍不住了	我實在忍不住【了】
钟鼓馔玉不足贵	【鍾】鼓饌玉不足貴
太阳升起的时候	太陽【升】起的時候
一定会引人注目	一定會引人【注】目
的最新游戏画面	的最新【遊】戲畫【面】
不知发生了什么	不知【發】生【了】什麼
发光二极管显示	【發】光二極管顯示
外交部发言人侯	外交部【發】言人侯
一发不可收拾的	一【發】不可收拾的
怎么看不见你了	怎麼看不見你【了】
我万万没有想到	我【萬】【萬】沒有想到
远水解不了近渴	遠水解不【了】近渴
言有尽而意无穷	言有【盡】而意無窮
非公开发行股份	非公開【發】行股份
劝君更尽一杯酒	勸君更【盡】一杯酒
的时候我才发现	的時候我【才】【發】現
驻伊美军发言人	駐伊美軍【發】言人
借问酒家何处有	【借】問酒家何處有
知道外面的世界	知道外【面】的世界
一个星期过去了	一個星期過去【了】
骨形态发生蛋白	骨形態【發】生蛋白
谁动了我的琴弦	誰動【了】我的琴弦
中国国民党大陆	中國國民【黨】大陸
并不能解决问题	【並】不能解決問題
投资者积极关注	投資者積極關【注】
意大利当地时间	意大利【當】地時間
瀚海阑干百丈冰	瀚海闌【幹】百丈冰
壮志饥餐胡虏肉	壯【志】【飢】餐【胡】虜肉
夜半钟声到客船	夜半【鍾】聲到客船
胡思乱想的时候	【胡】思亂想的時候
高堂明镜悲白发	高堂明鏡悲白【發】
并不能说明什么	【並】不能說明什麼
分布式操作系统	分【佈】式操作【係】統
在伊拉克被绑架	在伊拉【克】被綁架
怎一个愁字了得	怎一個愁字【了】得
美国进出口银行	美國進【出】口銀行
不好意思打错了	不好意思打錯【了】
同时履行抗辩权	【同】時履行抗辯權
一个小时过去了	一個小時過去【了】
进一步严格控制	進一步嚴格控【制】
不是那么一回事	不是那麼一【回】事
基于规则的系统	基於規則的【係】統
经人介绍认识了	經人介紹認識【了】
好久没见你了啊	好久沒見你【了】啊
何当共剪西窗烛	何【當】共剪西窗燭
客舍青青柳色新	客【舍】青青柳色新
耿耿星河欲曙天	耿耿星河【欲】曙天
夏有凉风冬有雪	夏有涼風【冬】有雪
我们还是分手了	我們還是分手【了】
一心只读圣贤书	一心【只】讀聖賢書
一片孤城万仞山	一片孤城【萬】仞山
伯克希尔哈撒韦	伯【克】希爾哈撒韋
有一种爱经不起	有一【種】愛經不起
第九个五年计划	第九個五年計【劃】
中美关系的发展	中美關【係】的【發】展
阿波罗登月计划	阿波羅登月計【劃】
我的世界只有你	我的世界【只】有你
黄鹤一去不复返	黃鶴一去不【復】返
八十年代出生的	八十年代【出】生的
你一定要幸福呀	你一定要【幸】福呀
欲寄彩笺兼尺素	【欲】寄【彩】箋兼尺素
羌笛何须怨杨柳	羌笛何【須】怨楊柳
庭院深深深几许	庭院深深深【幾】許
药物代谢动力学	【藥】物代謝動力學
期货价格每加仑	期貨價格每加【侖】
面向对象数据库	【面】【向】對象數【據】庫
千里江陵一日还	【千】【里】江陵一日還
表现的非常明白	【表】現的非常明白
焉耆回族自治县	焉耆【回】族自治縣
太平洋建设集团	太平洋建設集【團】
据消息灵通人士	【據】消息靈通人士
复方酮康唑乳膏	【復】方酮康唑乳膏
怎样才能让自己	怎樣【才】能讓自己
简直是天壤之别	簡直是天壤之【別】
胡思乱想睡不好	【胡】思亂想睡不好
我同年同月同日	我【同】年【同】月【同】日
只识弯弓射大雕	【只】識彎弓射大【雕】
花开堪折直须折	花開堪【折】直【須】【折】
朝辞白帝彩云间	朝辭白帝【彩】【雲】間
联合新闻发布会	聯合新聞【發】【佈】會
不小心摔了一跤	不小心摔【了】一跤
稻花香里说丰年	稻花香【里】說【豐】年
重整河山待后生	重整河山待【後】生
官方网站公布了	官方網站公【佈】【了】
何事长向别时圆	何事長【向】【別】時圓
什么时候才能再	什麼時候【才】能再
摩托罗拉公司的	摩【托】羅拉公司的
便纵有千种风情	便縱有【千】【種】風情
人生能有几回搏	人生能有【幾】【回】搏
五洲震荡风雷激	五洲震【蕩】風雷激
真人面前不说假	真人【面】前不說假
一定要注意身体	一定要【注】意身體
便下襄阳向洛阳	便下襄陽【向】洛陽
自己的开始懂了	自己的開始懂【了】
几个小时的时间	【幾】個小時的時間
我已经准备好了	我已經【準】備好【了】
多少楼台烟雨中	多少樓【臺】【煙】雨中
的博鳌亚洲论坛	的博鰲亞洲論【壇】
要我怎么忘了她	要我怎麼忘【了】她
五笔爱好者论坛	五筆愛好者論【壇】
最后一次世界杯	最【後】一次世界杯
的机会都没有了	的機會都沒有【了】
渚清沙白鸟飞回	渚清沙白鳥飛【回】
哪里来的骆驼队	哪【里】來的駱駝隊
发生在当地时间	【發】生在【當】地時間
没有勇气去面对	沒有勇氣去【面】對
全党全军和全国	全【黨】全軍和全國
最后一场热身赛	最【後】一場熱身賽
电外交部发言人	電外交部【發】言人
你的世界消失了	你的世界消失【了】
发生的一些事情	【發】生的一些事情
表白死了都要爱	【表】白死【了】都要愛
万事不由人计较	【萬】事不由人計較
我突然发现自己	我突然【發】現自己
门泊东吴万里船	門泊東吳【萬】【里】船
却道天凉好个秋	卻道天涼好個【秋】
捷克和斯洛伐克	捷【克】和斯洛伐【克】
最后还是选择了	最【後】還是選擇【了】
埋骨何须桑梓地	埋骨何【須】桑梓地
马上就要结束了	馬上就要結束【了】
草色烟光残照里	草色【煙】光殘照【里】
也没什么了不起	也沒什麼【了】不起
决胜于千里之外	決勝於【千】【里】之外
答记者问时表示	答記者問時【表】示
到尽头无话可说	到【盡】頭無話可說
未完成招生计划	未完成招生計【劃】
患有精神分裂症	患有精神分裂【症】
木里藏族自治县	木【里】藏族自治縣
哈萨克斯坦境内	哈薩【克】斯坦境內
系统性能监视器	【係】統性能監視器
等闲识得东风面	等閑識得東風【面】
里面什么都没有	【里】【面】什麼都沒有
线缆调制解调器	線纜調【制】解調器
怎么也哭不出来	怎麼也哭不【出】來
不知细叶谁裁出	不知細葉誰裁【出】
一段时间就好了	一段時間就好【了】
中国的网络游戏	中國的網絡【遊】戲
日照香炉生紫烟	日照香爐生紫【煙】
你什么时候才能	你什麼時候【才】能
申银万国分析师	申銀【萬】國分析師
让你知道去哪里	讓你知道去哪【里】
科尔沁左翼后旗	科爾沁左翼【後】旗
去年天气旧亭台	去年天氣舊亭【臺】
金樽清酒斗十千	金樽清酒【鬭】十【千】
可怜光彩生门户	可憐光【彩】生門戶
欲言又止的样子	【欲】言又止的樣子
单用户操作系统	單用戶操作【係】統
你是不是生气了	你是不是生氣【了】
谁看了她的屁屁	誰看【了】她的屁屁
高速缓冲存储器	高速緩【衝】存儲器
尽信书不如无书	【盡】信書不如無書
北斗阑干南斗斜	北【鬭】闌【幹】南【鬭】斜
感动得泪流满面	感動得淚流滿【面】
万物静观皆自得	【萬】物靜觀皆自得
好了伤疤忘了痛	好【了】傷疤忘【了】痛
尽日君王看不足	【盡】日君王看不足
非公开发行股票	非公開【發】行股票
科学技术部部长	科學技【術】部部長
只是在睡不着的	【只】是在睡不著的
长于春梦几多时	長於春夢【幾】多時
在你面前流眼泪	在你【面】前流眼淚
十年修得同船渡	十年修得【同】船渡
黄河远上白云间	黃河遠上白【雲】間
新华社记者表示	新華社記者【表】示
直道相思了无益	直道相思【了】無益
用户数据报协议	用戶數【據】報協議
云雨巫山枉断肠	【雲】雨巫山枉斷腸
做好了心理准备	做好【了】心理【準】備
一人做事一人当	一人做事一人【當】
表演型人格障碍	【表】演型人格障礙
防静电活动地板	防靜電活動地【板】
吃了上顿没下顿	吃【了】上頓沒下頓
两国关系正常化	兩國關【係】正常化
无党派爱国人士	無【黨】派愛國人士
与乌兹别克斯坦	與烏茲【別】【克】斯坦
网络游戏产业的	網絡【遊】戲產業的
有计划商品经济	有計【劃】商品經濟
又过了一段时间	又過【了】一段時間
这个世界上除了	這個世界上除【了】
计算机系统审计	計算機【係】統審計
忽复乘舟梦日边	忽【復】乘舟夢日邊
水随天去秋无际	水隨天去【秋】無際
哈萨克斯坦选手	哈薩【克】斯坦選手
风光不与四时同	風光不與四時【同】
占着茅坑不拉屎	【佔】著茅坑不拉屎
托马斯·阿奎那	【托】馬斯·阿奎那
白云千载空悠悠	白【雲】【千】載空悠悠
彩云易散琉璃脆	【彩】【雲】易散琉璃脆
地面卫星接收站	地【面】衛星接收站
古来万事东流水	古來【萬】事東流水
在同一个屋檐下	在【同】一個屋檐下
今天是最后一天	今天是最【後】一天
怎么看不到你了	怎麼看不到你【了】
欲饮琵琶马上催	【欲】飲琵琶馬上催
晴川历历汉阳树	晴川【歷】【歷】漢陽樹
斜风细雨不须归	斜風細雨不【須】歸
基于特征的设计	基於特【徵】的設計
歌尽桃花扇底风	歌【盡】桃花扇底風
不知道怎么样了	不知道怎麼樣【了】
第一夫人希拉里	第一夫人希拉【里】
为庆祝香港回归	爲慶祝香港【回】歸
表达自己的心情	【表】達自己的心情
漫卷诗书喜欲狂	漫【捲】詩書喜【欲】狂
会向瑶台月下逢	會【向】瑤【臺】月下逢
美人如花隔云端	美人如花隔【雲】端
在接受电话采访	在接受電話【採】訪
兰陵美酒郁金香	蘭陵美酒【鬱】金香
一寸还成千万缕	一寸還成【千】【萬】縷
铁骑突出刀枪鸣	鐵騎突【出】刀槍鳴
不知道怎么发泄	不知道怎麼【發】泄
今天我们要走了	今天我們要走【了】
十八姑娘一朵花	十八姑【娘】一朵花
总统米洛舍维奇	總統米洛【舍】維奇
寒食东风御柳斜	寒食東風【御】柳斜
察哈尔右翼后旗	察哈爾右翼【後】旗
你今年多大了啊	你今年多大【了】啊
我们还是分开了	我們還是分開【了】
伊朗国家电视台	伊朗國家電視【臺】
烟波江上使人愁	【煙】波江上使人愁
好汉不提当年勇	好漢不提【當】年勇
觉得自己很幸运	覺得自己很【幸】運
不教胡马度阴山	不教【胡】馬度陰山
以邮戳日期为准	以郵戳日期爲【準】
物欲横流的世界	物【欲】橫流的世界
一脸遗憾的表情	一臉遺憾的【表】情
换了一个又一个	換【了】一個又一個
美国国会参议院	美國國會【參】議院
化隆回族自治县	化隆【回】族自治縣
千里莺啼绿映红	【千】【里】鶯啼綠映紅
会挽雕弓如满月	會【挽】【雕】弓如滿月
模型参考自适应	模型【參】考自適應
瞎子点灯白费蜡	瞎子點燈白費【蠟】
这几天怎么过的	這【幾】天怎麼過的
发言人发表声明	【發】言人【發】【表】聲明
多媒体数据类型	多媒體數【據】類型
规范性法律文件	規【範】性法律文件
的大型演出活动	的大型演【出】活動
巴山夜雨涨秋池	巴山夜雨漲【秋】池
三千宠爱在一身	三【千】寵愛在一身
放学回家的路上	放學【回】家的路上
万类霜天竞自由	【萬】類霜天競自由
最终还是放弃了	最終還是放棄【了】
不该发生的事情	不該【發】生的事情
只愿君心似我心	【只】願君心似我心
让别人知道自己	讓【別】人知道自己
生子当如孙仲谋	生子【當】如孫仲謀
芙蓉如面柳如眉	芙蓉如【面】柳如眉
航空母舰战斗群	航空母艦戰【鬭】群
存在死了都要爱	存在死【了】都要愛
曲安奈德注射液	【曲】安奈德【注】射液
马上就要毕业了	馬上就要畢業【了】
根据国际奥委会	根【據】國際奧委會
雕栏玉砌应犹在	【雕】欄玉砌應猶在
会须一饮三百杯	會【須】一飲三百杯
面对自己内心的	【面】對自己內心的
万里长城万里长	【萬】【里】長城【萬】【里】長
怎么现在才来啊	怎麼現在【才】來啊
关公面前耍大刀	關公【面】前耍大刀
小车不倒只管推	小車不倒【只】管推
怒发冲冠凭栏处	怒【發】【衝】冠憑欄處
我以为你生气了	我以爲你生氣【了】
外交关系委员会	外交關【係】委員會
确立了恋爱关系	確立【了】戀愛關【係】
嫦娥应悔偷灵药	嫦娥應悔偷靈【藥】
新华网布鲁塞尔	新華網【佈】魯塞爾
社会主义所有制	社會主義所有【制】
青海长云暗雪山	青海長【雲】【暗】雪山
我是一个城里人	我是一個城【里】人
在原地等你回来	在原地等你【回】來
我的心中只有你	我的心中【只】有你
发现自己爱上了	【發】現自己愛上【了】
宝马雕车香满路	寶馬【雕】車香滿路
可能再回到从前	可能再【回】到從前
病魂常似秋千索	病魂常似【秋】【千】索
数据完整性保护	數【據】完整性保護
据新华社华盛顿	【據】新華社華盛頓
什么也没发生过	什麼也沒【發】生過
此地空余黄鹤楼	此地空【餘】黃鶴樓
狗嘴吐不出象牙	狗嘴吐不【出】象牙
隔江犹唱后庭花	隔江猶唱【後】庭花
最后的话我来说	最【後】的話我來說
欲渡黄河冰塞川	【欲】渡黃河冰塞川
发言人麦克莱伦	【發】言人麥【克】萊倫
什么时候回来啊	什麼時候【回】來啊
不善于表达自己	不善於【表】達自己
经营承包责任制	經營承包責任【制】
遥看瀑布挂前川	遙看瀑【佈】掛前川
新的一天开始了	新的一天開始【了】
饱汉不知饿汉饥	飽漢不知餓漢【飢】
别让我一个人醉	【別】讓我一個人醉
脑海里挥之不去	腦海【里】揮之不去
无缘对面不相逢	無緣對【面】不相逢
网络游戏开发商	網絡【遊】戲開【發】商
看你横行到几时	看你橫行到【幾】時
忘了自己姓什么	忘【了】自己姓什麼
一曲红绡不知数	一【曲】紅綃不知數
别想太多会不会	【別】想太多會不會
万条垂下绿丝绦	【萬】條垂下綠絲絛
两万五千里长征	兩【萬】五【千】【里】長【徵】
在西班牙马德里	在西班牙馬德【里】
东方光驱魔术师	東方光驅魔【術】師
东风不与周郎便	東風不與【周】郎便
多情自古伤别离	多情自古傷【別】離
派出所投案自首	派【出】所投案自首
络纬秋啼金井阑	絡緯【秋】啼金井闌
里面什么也没有	【里】【面】什麼也沒有
答应了他的要求	答應【了】他的要求
门源回族自治县	門源【回】族自治縣
胡天八月即飞雪	【胡】天八月即飛雪
中华网军事论坛	中華網軍事論【壇】
主教练斯科拉里	主教練斯科拉【里】
根本算不了什么	根本算不【了】什麼
远水救不了近火	遠水救不【了】近火
一切都来不及了	一切都來不及【了】
我终于忍不住了	我終於忍不住【了】
但悲不见九州同	但悲不見九州【同】
山回路转不见君	山【回】路轉不見君
属于我们的回忆	屬於我們的【回】憶
老总掏出十块钱	老總掏【出】十塊錢
人血丙种球蛋白	人血丙【種】球蛋白
网络游戏爱好者	網絡【遊】戲愛好者
萝卜快了不洗泥	蘿【卜】快【了】不洗泥
千古兴亡多少事	【千】古興亡多少事
马上就要过年了	馬上就要過年【了】
晓镜但愁云鬓改	曉鏡但愁【雲】鬢改
回答我一个问题	【回】答我一個問題
欲将心事付瑶琴	【欲】將心事付瑤琴
发生了一些事情	【發】生【了】一些事情
只要和你在一起	【只】要和你在一起
夕阳西下几时回	夕陽西下【幾】時【回】
这个世界充满了	這個世界充滿【了】
有花堪折直须折	有花堪【折】直【須】【折】
网络游戏的发展	網絡【遊】戲的【發】展
全员聘用合同制	全員聘用合【同】【制】
尘埃不见咸阳桥	塵埃不見【咸】陽橋
女朋友怎么样了	女朋友怎麼樣【了】
据第一财经日报	【據】第一財經日報
公安机关报了案	公安機關報【了】案
不管发生了什么	不管【發】生【了】什麼
告诉自己不准哭	告訴自己不【準】哭
当年拚却醉颜红	【當】年拚卻醉顏紅
那一夜你喝了酒	那一夜你喝【了】酒
绝胜烟柳满皇都	絕勝【煙】柳滿皇都
杰里斯塔克豪斯	【傑】【里】斯塔【克】豪斯
新闻请点击这里	新聞請點擊這【里】
在我面前的时候	在我【面】前的時候
发生的点点滴滴	【發】生的點點滴滴
同位素地球化学	【同】位素地球化學
使人听此凋朱颜	使人聽此凋【朱】顏
回到原来的地方	【回】到原來的地方
第八个五年计划	第八個五年計【劃】
似乎已经习惯了	似乎已經習慣【了】
好不容易等到了	好不容易等到【了】
所有人都遗忘了	所有人都遺忘【了】
腹中贮书一万卷	腹中貯書一【萬】【捲】
我的心没有回程	我的心沒有【回】程
不知道怎么说了	不知道怎麼說【了】
最新的游戏画面	最新的【遊】戲畫【面】
第一次见面是在	第一次見【面】是在
你在玩什么游戏	你在玩什麼【遊】戲
不知不觉就到了	不知不覺就到【了】
墙里秋千墙外道	牆【里】【秋】【千】牆外道
答应了她的要求	答應【了】她的要求
岐王宅里寻常见	岐王宅【里】尋常見
长风万里送秋雁	長風【萬】【里】送【秋】雁
不好意思发错了	不好意思【發】錯【了】
只是你生命中的	【只】是你生命中的
马上就要放假了	馬上就要放假【了】
在这一天出生的	在這一天【出】生的
毫不犹豫的回答	毫不猶豫的【回】答
笑语盈盈暗香去	笑語盈盈【暗】香去
不撞南墙不回头	不撞南牆不【回】頭
北风卷地白草折	北風【捲】地白草【折】
墙里开花墙外香	牆【里】開花牆外香
你现在在哪里呀	你現在在哪【里】呀
水殿风来暗香满	水殿風來【暗】香滿
九重城阙烟尘生	九重城闕【煙】塵生
是什么样的一种	是什麼樣的一【種】
八国集团领导人	八國集【團】領導人
东篱把酒黄昏后	東籬把酒黃昏【後】
才是真正的男人	【才】是真正的男人
特发性肺纤维化	特【發】性肺【纖】維化
在那里做什么啊	在那【里】做什麼啊
等闲离别易销魂	等閑離【別】易銷魂
呆呆的站在那里	呆呆的站在那【里】
在一起时间长了	在一起時間長【了】
别拿无知当个性	【別】拿無知【當】個性
克里夫兰骑士队	【克】【里】夫蘭騎士隊
踏上了回家的路	踏上【了】【回】家的路
不看僧面看佛面	不看僧【面】看佛【面】
我只想让你知道	我【只】想讓你知道
千金纵买相如赋	【千】金縱買相如賦
股份合作制经济	股份合作【制】經濟
叶叶声声是别离	葉葉聲聲是【別】離
了却君王天下事	【了】卻君王天下事
未成曲调先有情	未成【曲】調先有情
丰年留客足鸡豚	【豐】年留客足雞豚
一直很安静除了	一直很安靜除【了】
淡烟流水画屏幽	淡【煙】流水畫屏幽
的大型网络游戏	的大型網絡【遊】戲
别后不知君远近	【別】【後】不知君遠近
善恶到头终有报	善【惡】到頭終有報
计算机专业词汇	計算機專業詞【匯】
世上没有后悔药	世上沒有【後】悔【藥】
千里黄云白日曛	【千】【里】黃【雲】白日曛
百年多病独登台	百年多病獨登【臺】
江城子密州出猎	江城子密州【出】獵
什么理由一万个	什麼理由一【萬】個
枪杆子里出政权	槍桿子【里】【出】政權
君王掩面救不得	君王掩【面】救不得
世上如侬有几人	世上如儂有【幾】人
六军不发无奈何	六軍不【發】無奈何
径须沽取对君酌	徑【須】沽取對君酌
我只是一个平凡	我【只】是一個平凡
塞下秋来风景异	塞下【秋】來風景異
春心莫共花争发	春心莫共花爭【發】
外交部发言人阿	外交部【發】言人阿
万里悲秋常作客	【萬】【里】悲【秋】常作客
李白乘舟将欲行	李白乘舟將【欲】行
男朋友怎么样了	男朋友怎麼樣【了】
一年一度秋风劲	一年一度【秋】風勁
薄雾浓云愁永昼	薄霧濃【雲】愁永晝
注射用阿奇霉素	【注】射用阿奇霉素
经历了许多事情	經【歷】【了】許多事情
不得不面对现实	不得不【面】對現實
斗酒十千恣欢谑	【鬭】酒十【千】恣歡謔
在铁的事实面前	在鐵的事實【面】前
好好休息一下了	好好休息一下【了】
而今识尽愁滋味	而今識【盡】愁滋味
还有没有王法了	還有沒有王法【了】
怎么也找不到了	怎麼也找不到【了】
等到一千年以后	等到一【千】年以【後】
一别音容两渺茫	一【別】音容兩渺茫
罗带同心结未成	羅帶【同】心結未成
混同于一般群众	混【同】於一般群眾
万国衣冠拜冕旒	【萬】國衣冠拜冕旒
烟笼寒水月笼沙	【煙】籠寒水月籠沙
风住尘香花已尽	風住塵香花已【盡】
恶语伤人六月寒	【惡】語傷人六月寒
欲报倾城随太守	【欲】報傾城隨太守
跟以前不一样了	跟以前不一樣【了】
如果能回到从前	如果能【回】到從前
云破月来花弄影	【雲】破月來花弄影
承担应尽的义务	承擔應【盡】的義務
拨打了报警电话	撥打【了】報警電話
只属于我一个人	【只】屬於我一個人
枸橼酸喷托维林	枸櫞酸噴【托】維林
出生的那一刻起	【出】生的那一刻起
总是当时携手处	總是【當】時攜手處
你是不是发错了	你是不是【發】錯【了】
软硬件协同设计	軟硬件協【同】設計
万顷波中得自由	【萬】頃波中得自由
你不要胡思乱想	你不要【胡】思亂想
伊拉克基地组织	伊拉【克】基地組織
面向制造的设计	【面】【向】【制】造的設計
布拉马普特拉河	【佈】拉馬普特拉河
彩袖殷勤捧玉钟	【彩】袖殷勤捧玉【鍾】
我就不打扰你了	我就不打擾你【了】
鸿飞那复计东西	鴻飛那【復】計東西
今年欢笑复明年	今年歡笑【復】明年
确定性控制系统	確定性控【制】【係】統
第一次感觉到了	第一次感覺到【了】
多情只有春庭月	多情【只】有春庭月
浪花有意千重雪	浪花有意【千】重雪
明天就要开学了	明天就要開學【了】
须行即骑访名山	【須】行即騎訪名山
麦克斯韦方程组	麥【克】斯韋方程組
表面活性剂体系	【表】【面】活性劑體【係】
你不是回家了吗	你不是【回】家【了】嗎
什么时候回去啊	什麼時候【回】去啊
永远不会再回来	永遠不會再【回】來
玛瑟里顿的巢穴	瑪瑟【里】頓的巢穴
扪参历井仰胁息	捫【參】【歷】井仰脅息
几回魂梦与君同	【幾】【回】魂夢與君【同】
厚重异种虫胸甲	厚重異【種】蟲胸甲
网络游戏行业的	網絡【遊】戲行業的
事如春梦了无痕	事如春夢【了】無痕
好心当作驴肝肺	好心【當】作驢肝肺
觉得自己长大了	覺得自己長大【了】
现在玩什么游戏	現在玩什麼【遊】戲
喜见外弟又言别	喜見外弟又言【別】
死马当作活马医	死馬【當】作活馬醫
到目前为止并在	到目前爲止【並】在
御敌于国门之外	【御】敵於國門之外
别时茫茫江浸月	【別】時茫茫江浸月
只有相思无尽处	【只】有相思無【盡】處
彩笔新题断肠句	【彩】筆新題斷腸句
维也纳交响乐团	維也納交響樂【團】
编程只读存储器	編程【只】讀存儲器
游戏客户端以及	【遊】戲客戶端以及
沃利斯泽比亚克	沃利斯澤比亞【克】
离不开你你了解	離不開你你【了】解
电子捕获检测器	電子捕【獲】檢測器
分布式计算环境	分【佈】式計算環境
伤尽我心的说话	傷【盡】我心的說話
碧野朱桥当日事	碧野【朱】橋【當】日事
长大以后现在的	長大以【後】現在的
朱雀桥边野草花	【朱】雀橋邊野草花
第一次发现自己	第一次【發】現自己
火山喷发太平洋	火山噴【發】太平洋
情疏迹远只香留	情疏跡遠【只】香留
别有幽愁暗恨生	【別】有幽愁【暗】恨生
知道自己做错了	知道自己做錯【了】
在我们的记忆里	在我們的記憶【里】
说尽心中无限事	說【盡】心中無限事
外科手术式打击	外科手【術】式打擊
光固化复合树脂	光固化【復】合樹脂
萨达姆同母异父	薩達姆【同】母異父
不知不觉睡着了	不知不覺睡著【了】
不尽长江滚滚流	不【盡】長江滾滾流
这你就不知道了	這你就不知道【了】
我才知道原来我	我【才】知道原來我
你吃饭了没有啊	你吃飯【了】沒有啊
参加雅典奥运会	【參】加雅典奧運會
云鬓半偏新睡觉	【雲】鬢半偏新睡覺
不甘心只是朋友	不甘心【只】是朋友
海南特别行政区	海南特【別】行政區
的成绩获得冠军	的成績【獲】得冠軍
动不动就发脾气	動不動就【發】脾氣
在玩什么游戏啊	在玩什麼【遊】戲啊
他什么时候回来	他什麼時候【回】來
你一定爱上了我	你一定愛上【了】我
风情万种的女人	風情【萬】【種】的女人
高楼目尽欲黄昏	高樓目【盡】【欲】黃昏
塞纳里奥远征队	塞納【里】奧遠【徵】隊
壮志未酬身先死	壯【志】未酬身先死
四时佳兴与人同	四時佳興與人【同】
过去的都过去了	過去的都過去【了】
复方地芬诺酯片	【復】方地芬諾酯片
感烟火灾探测器	感【煙】火災探測器
回头下望人寰处	【回】頭下望人寰處
你现在在那里呢	你現在在那【里】呢
百世修来同船渡	百世修來【同】船渡
盎格鲁撒克逊人	盎格魯撒【克】遜人
舍南舍北皆春水	【舍】南【舍】北皆春水
艾里莆与赛乃姆	艾【里】莆與賽乃姆
拒人以千里之外	拒人以【千】【里】之外
不好意思打扰了	不好意思打擾【了】
伊拉克研究小组	伊拉【克】研究小組
这条消息太毒了	這條消息太毒【了】
梦入江南烟水路	夢入江南【煙】水路
死去元知万事空	死去元知【萬】事空
以公有制为基础	以公有【制】爲基礎
千载琵琶作胡语	【千】載琵琶作【胡】語
不过是过眼云烟	不過是過眼【雲】【煙】
发生的恐怖袭击	【發】生的恐怖襲擊
白云生处有人家	白【雲】生處有人家
脑子里只有一个	腦子【里】【只】有一個
非洲金融共同体	非洲金融共【同】體
我的心里充满了	我的心【里】充滿【了】
江流曲似九回肠	江流【曲】似九【回】腸
千世修来共枕眠	【千】世修來共枕眠
始共春风容易别	始共春風容易【別】
不好意思我忘了	不好意思我忘【了】
马上就要过去了	馬上就要過去【了】
向阳花木早逢春	【向】陽花木早逢春
已经过去很久了	已經過去很久【了】
国际标准交谊舞	國際標【準】交誼舞
鼓声渐远游人散	鼓聲漸遠【遊】人散
破历史最高纪录	破【歷】史最高紀錄
雅典奥运会之后	雅典奧運會之【後】
从国家利益出发	從國家利益【出】【發】
一辈子只有一次	一輩子【只】有一次
共同战斗的战友	共【同】戰【鬭】的戰友
小组赛最后一轮	小組賽最【後】一輪
五彩斑斓的世界	五【彩】斑斕的世界
时人不识余心乐	時人不識【餘】心樂
唯见江心秋月白	唯見江心【秋】月白
醋酸氟轻松软膏	醋酸氟輕【鬆】軟膏
只恐双溪舴艋舟	【只】恐雙溪舴艋舟
九万里风鹏正举	九【萬】【里】風鵬正舉
艾森克人格问卷	艾森【克】人格問【捲】
浊酒一杯家万里	濁酒一杯家【萬】【里】
我只是随便说说	我【只】是隨便說說
市场上这里看看	市場上這【里】看看
葫芦里卖什么药	葫蘆【里】賣什麼【藥】
好马不吃回头草	好馬不吃【回】頭草
晚妆初了明肌雪	晚妝初【了】明肌雪
并不能代表什么	【並】不能代【表】什麼
御宇多年求不得	【御】宇多年求不得
孤灯挑尽未成眠	孤燈挑【盡】未成眠
在本赛季结束后	在本賽季結束【後】
云鬓花颜金步摇	【雲】鬢花顏金步搖
放松自己的心情	放【鬆】自己的心情
一面风情深有韵	一【面】風情深有韻
混凝土设计规范	混凝土設計規【範】
欲将沉醉换悲凉	【欲】將沉醉換悲涼
我对你一见钟情	我對你一見【鍾】情
暗淡轻黄体性柔	【暗】淡輕黃體性柔
国际建筑师协会	國際建【築】師協會
纳克萨玛斯之影	納【克】薩瑪斯之影
拿着鸡毛当令箭	拿著雞毛【當】令箭
脑海里一片空白	腦海【里】一片空白
暗随流水到天涯	【暗】隨流水到天涯
乘长风破万里浪	乘長風破【萬】【里】浪
向父母打小报告	【向】父母打小報告
纽伦堡法兰克人	紐倫堡法蘭【克】人
做了什么对不起	做【了】什麼對不起
轮台东门送君去	輪【臺】東門送君去
富贵于我如浮云	富貴於我如浮【雲】
村庄儿女各当家	村莊兒女各【當】家
肯定是要退出了	肯定是要退【出】【了】
电路交换数据网	電路交換數【據】網
你现在在家里吗	你現在在家【里】嗎
可信计算机系统	可信計算機【係】統
秋登兰山寄张五	【秋】登蘭山寄張五
一叶落知天下秋	一葉落知天下【秋】
春江花朝秋月夜	春江花朝【秋】月夜
耶娘妻子走相送	耶【娘】妻子走相送
请你一定要幸福	請你一定要【幸】福
楼阁玲珑五云起	樓閣玲瓏五【雲】起
御虎国防科普网	【御】虎國防科普網
梦游听妈妈的话	夢【遊】聽媽媽的話
再回头已百年身	再【回】頭已百年身
什么时候回家呀	什麼時候【回】家呀
孤立词语音识别	孤立詞語音識【別】
几曾着眼看侯王	【幾】曾著眼看侯王
惊破霓裳羽衣曲	驚破霓裳羽衣【曲】
注射用绒促性素	【注】射用絨促性素
借酒浇愁愁更愁	【借】酒澆愁愁更愁
在我们的世界里	在我們的世界【里】
同仁乌鸡白凤丸	【同】仁烏雞白鳳丸
我知道你是谁了	我知道你是誰【了】
我只是实话实说	我【只】是實話實說
胡琴琵琶与羌笛	【胡】琴琵琶與羌笛
奥斯里安的束缚	奧斯【里】安的束縛
欲上青天览明月	【欲】上青天覽明月
商人重利轻别离	商人重利輕【別】離
什么时候才能在	什麼時候【才】能在
多媒体数据模型	多媒體數【據】模型
什么时候回来了	什麼時候【回】來【了】
云母屏风烛影深	【雲】母屏風燭影深
三步并作两步走	三步【並】作兩步走
安德烈基里连科	安德烈基【里】連科
钟山只隔数重山	【鍾】山【只】隔數重山
斜光到晓穿朱户	斜光到曉穿【朱】戶
打破了世界纪录	打破【了】世界紀錄
冉冉秋光留不住	冉冉【秋】光留不住
千万不要让自己	【千】【萬】不要讓自己
马上就要开学了	馬上就要開學【了】
明天又要上班了	明天又要上班【了】
清月出岭光入扉	清月【出】嶺光入扉
平林新月人归后	平林新月人歸【後】
笙歌散尽游人去	笙歌散【盡】【遊】人去
沙上并禽池上暝	沙上【並】禽池上暝
春风十里扬州路	春風十【里】揚州路
那一种寸步不离	那一【種】寸步不離
谁人背后无人说	誰人背【後】無人說
失去的只是一个	失去的【只】是一個
二十五味松石丸	二十五味【鬆】石丸
复方板蓝根颗粒	【復】方【板】藍根顆粒
什么病吃什么药	什麼病吃什麼【藥】
一波才动万波随	一波【才】動【萬】波隨
有时候只是一个	有時候【只】是一個
歌声共水流云断	歌聲共水流【雲】斷
迟发型超敏反应	遲【發】型超敏反應
枫叶荻花秋瑟瑟	楓葉荻花【秋】瑟瑟
问君西游何时还	問君西【遊】何時還
在落后的情况下	在落【後】的情況下
吃了原告吃被告	吃【了】原告吃被告
松间沙路净无泥	【鬆】間沙路凈無泥
玉容寂寞泪阑干	玉容寂寞淚闌【幹】
平芜尽处是春山	平蕪【盡】處是春山
当时若不登高望	【當】時若不登高望
当时共我赏花人	【當】時共我賞花人
往事后期空记省	往事【後】期空記省
合成表面活性剂	合成【表】【面】活性劑
计算机辅助制图	計算機輔助【制】圖
分布式对象技术	分【佈】式對象技【術】
狂爱龙卷风恋曲	狂愛龍【捲】風戀【曲】
注射用头孢拉定	【注】射用頭孢拉定
长烟落日孤城闭	長【煙】落日孤城閉
沈园柳老不吹绵	【瀋】園柳老不吹綿
中间小谢又清发	中間小謝又清【發】
识实务者为俊杰	識實務者爲俊【傑】
数声和月到帘栊	數聲和月到【簾】櫳
现在已经习惯了	現在已經習慣【了】
回看天际下中流	【回】看天際下中流
分手后还是朋友	分手【後】還是朋友
好了不和你聊了	好【了】不和你聊【了】
百草千花寒食路	百草【千】花寒食路
我只是随便问问	我【只】是隨便問問
路边野花不要采	路邊野花不要【採】
将军白发征夫泪	將軍白【發】【徵】夫淚
陪你一起打游戏	陪你一起打【遊】戲
在我们的生命里	在我們的生命【里】
游戏论坛等你来	【遊】戲論【壇】等你來
解热镇痛抗炎药	解熱鎮痛抗炎【藥】
只要你在我身边	【只】要你在我身邊
回避型人格障碍	【回】避型人格障礙
签署了合作协议	【籖】署【了】合作協議
波心荡冷月无声	波心【蕩】冷月無聲
二十余年如一梦	二十【餘】年如一夢
一剑曾当百万师	一劍曾【當】百【萬】師
公布的民意调查	公【佈】的民意調查
怎么也说不出口	怎麼也說不【出】口
西非经济共同体	西非經濟共【同】體
郁孤台下清江水	【鬱】孤【臺】下清江水
只争来早与来迟	【只】爭來早與來遲
我只是一个过客	我【只】是一個過客
人间别久不成悲	人間【別】久不成悲
一切都是为了你	一切都是爲【了】你
五角大楼发言人	五角大樓【發】言人
千村万落生荆杞	【千】村【萬】落生荊杞
幸福到底是什么	【幸】福到底是什麼
送春春去几时回	送春春去【幾】時【回】
长江后浪催前浪	長江【後】浪催前浪
绿杨烟外晓寒轻	綠楊【煙】外曉寒輕
有缘千里来相会	有緣【千】【里】來相會
等我回来的时候	等我【回】來的時候
归云一去无踪迹	歸【雲】一去無蹤跡
正是河豚欲上时	正是河豚【欲】上時
玉人浴出新妆洗	玉人浴【出】新妝洗
早点回去休息吧	早點【回】去休息吧
心病还得心药医	心病還得心【藥】醫
不要想那么多了	不要想那麼多【了】
四面边声连角起	四【面】邊聲連角起
秋雨梧桐叶落时	【秋】雨梧桐葉落時
牙科综合治疗台	牙科綜合治療【臺】
复方五味子糖浆	【復】方五味子糖漿
万氏牛黄清心丸	【萬】氏牛黃清心丸
不要人夸颜色好	不要人【誇】顏色好
解铃还得系铃人	解鈴還得【係】鈴人
猿猱欲度愁攀援	猿猱【欲】度愁攀援
群山万壑赴荆门	群山【萬】壑赴荊門
走到尽头的时候	走到【盡】頭的時候
更多精彩小游戏	更多精【彩】小【遊】戲
比赛的最后时刻	比賽的最【後】時刻
我已经不记得了	我已經不記得【了】
离开了这个城市	離開【了】這個城市
副总理伊万诺夫	副總理伊【萬】諾夫
贾生才调更无伦	賈生【才】調更無倫
宰相肚里好撑船	宰相肚【里】好撐船
复方氢氧化铝片	【復】方氫氧化鋁片
徒要教郎比并看	徒要教郎比【並】看
蜡烛有心还惜别	【蠟】燭有心還惜【別】
云淡风轻近午天	【雲】淡風輕近午天
玉树琼枝作烟萝	玉樹瓊枝作【煙】蘿
对象链接与嵌入	對象【鏈】接與嵌入
崔九堂前几度闻	崔九堂前【幾】度聞
是我的高中同学	是我的高中【同】學
千金难买老来瘦	【千】金難買老來瘦
人间能得几回闻	人間能得【幾】【回】聞
贾氏窥帘韩掾少	賈氏窺【簾】韓掾少
心病还须心药医	心病還【須】心【藥】醫
输入输出处理器	輸入輸【出】處理器
微内核操作系统	微內核操作【係】統
只疑松动要来扶	【只】疑【鬆】動要來扶
过尽飞鸿字字愁	過【盡】飛鴻字字愁
九华帐里梦魂惊	九華帳【里】夢魂驚
散入珠帘湿罗幕	散入珠【簾】濕羅幕
