科技发展有限公司	科技【發】展有限公司
网络技术有限公司	網絡技【術】有限公司
有一种爱叫做放手	有一【種】愛叫做放手
保持共产党员先进	保持共產【黨】員先進
质量管理体系认证	質量管理體【係】認證
科技开发有限公司	科技開【發】有限公司
发展和改革委员会	【發】展和改革委員會
全面建设小康社会	全【面】建設小康社會
全国人民代表大会	全國人民代【表】大會
中国科学技术大学	中國科學技【術】大學
非公有制经济发展	非公有【制】經濟【發】展
到底是怎么一回事	到底是怎麼一【回】事
塑胶制品有限公司	塑膠【制】品有限公司
坚持以科学发展观	堅持以科學【發】展觀
上海浦东发展银行	上海浦東【發】展銀行
坏蛋是怎样炼成的	壞蛋是怎樣【煉】成的
机械制造有限公司	機械【制】造有限公司
出入境检验检疫局	【出】入境檢驗檢疫局
信息技术有限公司	信息技【術】有限公司
实业集团有限公司	實業集【團】有限公司
的房地产开发企业	的房地產開【發】企業
加强党的执政能力	加強【黨】的執政能力
党的执政能力建设	【黨】的執政能力建設
新疆生产建设兵团	新疆生產建設兵【團】
党的路线方针政策	【黨】的路線方【針】政策
控股集团有限公司	控股集【團】有限公司
师范高等专科学校	師【範】高等專科學校
中国国际广播电台	中國國際廣播電【臺】
立党为公执政为民	立【黨】爲公執政爲民
实业发展有限公司	實業【發】展有限公司
集团股份有限公司	集【團】股份有限公司
疾病预防控制中心	疾病預防控【制】中心
计算机科学与技术	計算機科學與技【術】
不知道说什么好了	不知道說什麼好【了】
中央人民广播电台	中央人民廣播電【臺】
技术发展有限公司	技【術】【發】展有限公司
发展股份有限公司	【發】展股份有限公司
集团有限责任公司	集【團】有限責任公司
国家中医药管理局	國家中醫【藥】管理局
软件技术有限公司	軟件技【術】有限公司
经济社会发展全局	經濟社會【發】展全局
建设集团有限公司	建設集【團】有限公司
推动经济社会发展	推動經濟社會【發】展
房地产开发企业的	房地產開【發】企業的
经济社会协调发展	經濟社會協調【發】展
为了解决这个问题	爲【了】解決這個問題
不知道该怎么回答	不知道該怎麼【回】答
科学发展观的要求	科學【發】展觀的要求
全面推进素质教育	全【面】推進素質教育
和计划生育委员会	和計【劃】生育委員會
比去年同期增长了	比去年【同】期增長【了】
我想你了我想你了	我想你【了】我想你【了】
市质量技术监督局	市質量技【術】監督局
贯彻胡锦涛总书记	貫徹【胡】錦濤總書記
专业技术资格考试	專業技【術】資格考試
学习胡锦涛总书记	學習【胡】錦濤總書記
交通职业技术学院	交通職業技【術】學院
我和僵尸有个约会	我和【僵】【屍】有個約會
统领经济社会发展	統領經濟社會【發】展
知道什么时候才能	知道什麼時候【才】能
中华民族伟大复兴	中華民族偉大【復】興
技术股份有限公司	技【術】股份有限公司
建立现代企业制度	建立現代企業【制】度
我不知道说什么了	我不知道說什麼【了】
信息职业技术学院	信息職業技【術】學院
质量技术监督部门	質量技【術】監督部門
全党全国各族人民	全【黨】全國各族人民
信托投资有限公司	信【托】投資有限公司
电子技术有限公司	電子技【術】有限公司
人民代表大会代表	人民代【表】大會代【表】
经济社会发展情况	經濟社會【發】展情況
突发公共卫生事件	突【發】公共衛生事件
土地利用总体规划	土地利用總體規【劃】
钢铁是怎样炼成的	鋼鐵是怎樣【煉】成的
药业股份有限公司	【藥】業股份有限公司
促进人的全面发展	促進人的全【面】【發】展
标准化技术委员会	標【準】化技【術】委員會
第一次见面的地方	第一次見【面】的地方
党政领导干部选拔	【黨】政領導【幹】部選拔
客户关系管理系统	客戶關【係】管理【係】統
落实科学发展观的	落實科學【發】展觀的
面朝大海春暖花开	【面】朝大海春暖花開
金属制品有限公司	金屬【制】品有限公司
国家新闻出版总署	國家新聞【出】版總署
工程技术研究中心	工程技【術】研究中心
城乡经济社会发展	城鄉經濟社會【發】展
铁道部新闻发言人	鐵道部新聞【發】言人
好好学习天天向上	好好學習天天【向】上
发展有限责任公司	【發】展有限責任公司
战略合作伙伴关系	戰略合作【夥】伴關【係】
食品药品监督管理	食品【藥】品監督管理
睁一只眼闭一只眼	睜一【只】眼閉一【只】眼
国家统计局公布的	國家統計局公【佈】的
收入分配制度改革	收入分配【制】度改革
社会的可持续发展	社會的可持續【發】展
是落实科学发展观	是落實科學【發】展觀
胡锦涛总书记重要	【胡】錦濤總書記重要
网络发展有限公司	網絡【發】展有限公司
几乎可以忽略不计	【幾】乎可以忽略不計
发电有限责任公司	【發】電有限責任公司
投资发展有限公司	投資【發】展有限公司
届奥林匹克运动会	屆奧林匹【克】運動會
开发有限责任公司	開【發】有限責任公司
清华大学美术学院	清華大學美【術】學院
干部人事制度改革	【幹】部人事【制】度改革
落实胡锦涛总书记	落實【胡】錦濤總書記
科技发展有限责任	科技【發】展有限責任
完善社会保障体系	完善社會保障體【係】
胡锦涛总书记提出	【胡】錦濤總書記提【出】
标准化管理委员会	標【準】化管理委員會
人与自然和谐发展	人與自然和諧【發】展
适用法律若干问题	適用法律若【幹】問題
你怎么舍得我难过	你怎麼【舍】得我難過
塑料制品有限公司	塑料【制】品有限公司
食品药品监管工作	食品【藥】品監管工作
一千个伤心的理由	一【千】個傷心的理由
根据最高人民法院	根【據】最高人民法院
技术开发有限公司	技【術】開【發】有限公司
大力发展职业教育	大力【發】展職業教育
社会保障体系建设	社會保障體【係】建設
领导干部廉洁自律	領導【幹】部廉潔自律
发生了很大的变化	【發】生【了】很大的變化
那你什么时候回来	那你什麼時候【回】來
大力发展循环经济	大力【發】展循環經濟
伊犁哈萨克自治州	伊犁哈薩【克】自治州
不尽如人意的地方	不【盡】如人意的地方
中国农业发展银行	中國農業【發】展銀行
在全国范围内开展	在全國【範】圍內開展
面向对象程序设计	【面】【向】對象程序設計
中国网络游戏市场	中國網絡【遊】戲市場
淘汰落后生产能力	淘汰落【後】生產能力
中国优秀旅游城市	中國優秀旅【遊】城市
一人之下万人之上	一人之下【萬】人之上
人力资源管理系统	人力資源管理【係】統
人民代表大会制度	人民代【表】大會【制】度
你怎么又不说话了	你怎麼又不說話【了】
发展中国家领导人	【發】展中國家領導人
投资集团有限公司	投資集【團】有限公司
比去年同期下降了	比去年【同】期下降【了】
三大纪律八项注意	三大紀律八項【注】意
制药有限公司生产	【制】【藥】有限公司生產
我国经济社会发展	我國經濟社會【發】展
企业发展有限公司	企業【發】展有限公司
房地产市场的发展	房地產市場的【發】展
血小板减少性紫癜	血小【板】減少性紫癜
社会主义法制建设	社會主義法【制】建設
坚持党的基本路线	堅持【黨】的基本路線
食品药品监管部门	食品【藥】品監管部門
药业有限公司生产	【藥】業有限公司生產
中国科学技术协会	中國科學技【術】協會
等党和国家领导人	等【黨】和國家領導人
建筑工程有限公司	建【築】工程有限公司
最大的发展中国家	最大的【發】展中國家
经济社会发展中的	經濟社會【發】展中的
深化文化体制改革	深化文化體【制】改革
联合国开发计划署	聯合國開【發】計【劃】署
中共中央关于制定	中共中央關於【制】定
参加基本养老保险	【參】加基本養老保險
接受记者采访时称	接受記者【採】訪時稱
中国经济社会发展	中國經濟社會【發】展
文化发展有限公司	文化【發】展有限公司
接受记者采访时说	接受記者【採】訪時說
中国航天科技集团	中國航天科技集【團】
和落实科学发展观	和落實科學【發】展觀
可以根据实际情况	可以根【據】實際情況
医疗卫生体制改革	醫療衛生體【制】改革
密克罗尼西亚联邦	密【克】羅尼西亞聯邦
最低生活保障制度	最低生活保障【制】度
一分耕耘一分收获	一分耕耘一分收【獲】
发展中国家的发展	【發】展中國家的【發】展
善有善报恶有恶报	善有善報【惡】有【惡】報
读万卷书行万里路	讀【萬】【捲】書行【萬】【里】路
走自己的路让别人	走自己的路讓【別】人
疾病预防控制机构	疾病預防控【制】機構
西部大开发战略的	西部大開【發】戰略的
不知道该怎么面对	不知道該怎麼【面】對
我不知道怎么回事	我不知道怎麼【回】事
工业职业技术学院	工業職業技【術】學院
国家历史文化名城	國家【歷】史文化名城
人与人之间的关系	人與人之間的關【係】
经济的可持续发展	經濟的可持續【發】展
国务院办公厅转发	國務院辦公廳轉【發】
促进区域协调发展	促進區域協調【發】展
华为技术有限公司	華爲技【術】有限公司
客户关系管理软件	客戶關【係】管理軟件
也不知道怎么回事	也不知道怎麼【回】事
一个新的发展阶段	一個新的【發】展階段
国务院法制办公室	國務院法【制】辦公室
当地最低工资标准	【當】地最低工資標【準】
自治区党委副书记	自治區【黨】委副書記
十届全国人大代表	十屆全國人大代【表】
房地产业健康发展	房地產業健康【發】展
北京人民广播电台	北京人民廣播電【臺】
贸易发展有限公司	貿易【發】展有限公司
促进非公有制经济	促進非公有【制】經濟
克孜勒苏柯尔克孜	【克】孜勒【蘇】柯爾【克】孜
什么时候回来的啊	什麼時候【回】來的啊
法律面前人人平等	法律【面】前人人平等
香港特别行政区的	香港特【別】行政區的
也不知道是怎么了	也不知道是怎麼【了】
突发事件应急预案	突【發】事件應急預案
提高存款准备金率	提高存款【準】備金率
心急吃不了热豆腐	心急吃不【了】熱豆腐
总书记胡锦涛主持	總書記【胡】錦濤主持
高技术产业开发区	高技【術】產業開【發】區
家庭经济困难学生	家庭經濟【困】難學生
我也不知道怎么了	我也不知道怎麼【了】
知道自己是怎么了	知道自己是怎麼【了】
主营业务收入同比	主營業務收入【同】比
外面的世界很精彩	外【面】的世界很精【彩】
国家发改委副主任	國家【發】改委副主任
在全省范围内开展	在全省【範】圍內開展
国家旅游局副局长	國家旅【遊】局副局長
马克思主义中国化	馬【克】思主義中國化
中国电信集团公司	中國電信集【團】公司
天津滨海新区开发	天津濱海新區開【發】
我不知道怎么说了	我不知道怎麼說【了】
己所不欲勿施于人	己所不【欲】勿施於人
从此以后再也没有	從此以【後】再也沒有
只是不知道为什么	【只】是不知道爲什麼
你怎么不说话了呢	你怎麼不說話【了】呢
体育彩票管理中心	體育【彩】票管理中心
小泉参拜靖国神社	小泉【參】拜靖國神社
控制固定资产投资	控【制】固定資產投資
我只是一个普通的	我【只】是一個普通的
取之不尽用之不竭	取之不【盡】用之不竭
非公有制经济人士	非公有【制】經濟人士
一人得道鸡犬升天	一人得道雞犬【升】天
怎么又不说话了啊	怎麼又不說話【了】啊
美国前总统克林顿	美國前總統【克】林頓
突然出现在我面前	突然【出】現在我【面】前
火灾自动报警系统	火災自動報警【係】統
他在接受记者采访	他在接受記者【採】訪
创造了一个又一个	創造【了】一個又一個
没有什么大不了的	沒有什麼大不【了】的
个人党性分析材料	個人【黨】性分析材料
在美国佛罗里达州	在美國佛羅【里】達州
和香港特别行政区	和香港特【別】行政區
男女搭配干活不累	男女搭配【幹】活不纍
路边的野花不要采	路邊的野花不要【採】
你怎么不说话了啊	你怎麼不說話【了】啊
了全国人大常委会	【了】全國人大常委會
君子报仇十年不晚	君子報【仇】十年不晚
引导非公有制经济	引導非公有【制】經濟
小时最低工资标准	小時最低工資標【準】
千里之行始于足下	【千】【里】之行始於足下
集团公司副总经理	集【團】公司副總經理
全球卫星定位系统	全球衛星定位【係】統
鞠躬尽瘁死而后已	鞠躬【盡】瘁死而【後】已
当我再爱你的时候	【當】我再愛你的時候
国家统计局的数据	國家統計局的數【據】
中国移动通信集团	中國移動通信集【團】
具有特别重要意义	具有特【別】重要意義
这个世界上最幸福	這個世界上最【幸】福
直到现在我才知道	直到現在我【才】知道
中央工艺美术学院	中央工藝美【術】學院
当局者迷旁观者清	【當】局者迷旁觀者清
亲民党主席宋楚瑜	親民【黨】主席宋楚瑜
你现在在干什么呢	你現在在【幹】什麼呢
中国外汇交易中心	中國外【匯】交易中心
习惯了一个人生活	習慣【了】一個人生活
国际信托投资公司	國際信【托】投資公司
点击查看更多精彩	點擊查看更多精【彩】
突然出现在他面前	突然【出】現在他【面】前
中国外交部发言人	中國外交部【發】言人
胡锦涛总书记关于	【胡】錦濤總書記關於
萝卜白菜各有所爱	蘿【卜】白菜各有所愛
到底什么时候才能	到底什麼時候【才】能
青少年发展基金会	青少年【發】展基金會
商务部新闻发言人	商務部新聞【發】言人
只要你过得比我好	【只】要你過得比我好
增强共青团员意识	增強共青【團】員意識
更加注重社会公平	更加【注】重社會公平
大学本科以上学历	大學本科以上學【歷】
今天不知道怎么了	今天不知道怎麼【了】
两岸关系和平发展	兩岸關【係】和平【發】展
千方百计扩大就业	【千】方百計擴大就業
前无古人后无来者	前無古人【後】無來者
个性签名个性签名	個性【籖】名個性【籖】名
哈萨克斯坦共和国	哈薩【克】斯坦共和國
国民党革命委员会	國民【黨】革命委員會
国家质检总局公布	國家質檢總局公【佈】
发展研究中心主任	【發】展研究中心主任
奥林匹克体育中心	奧林匹【克】體育中心
新长征路上的摇滚	新長【徵】路上的搖滾
举行了新闻发布会	舉行【了】新聞【發】【佈】會
风中有朵雨做的云	風中有朵雨做的【雲】
东方早报记者采访	東方早報記者【採】訪
近朱者赤近墨者黑	近【朱】者赤近墨者黑
共产党中央委员会	共產【黨】中央委員會
只不过是从头再来	【只】不過是從頭再來
明修栈道暗渡陈仓	明修棧道【暗】渡陳倉
同年同月同日生的	【同】年【同】月【同】日生的
日复一日年复一年	日【復】一日年【復】一年
也不知道为了什么	也不知道爲【了】什麼
大事化小小事化了	大事化小小事化【了】
生物药业有限公司	生物【藥】業有限公司
萝卜青菜各有所爱	蘿【卜】青菜各有所愛
中国十大杰出青年	中國十大【傑】【出】青年
这个世界上消失了	這個世界上消失【了】
天要下雨娘要嫁人	天要下雨【娘】要嫁人
纳斯达克综合指数	納斯達【克】綜合指數
一种相思两处闲愁	一【種】相思兩處閑愁
中国公民出境旅游	中國公民【出】境旅【遊】
对房地产开发企业	對房地產開【發】企業
好久没有看到你了	好久沒有看到你【了】
第十一个五年规划	第十一個五年規【劃】
外面的世界很无奈	外【面】的世界很無奈
说了你也不知道啊	說【了】你也不知道啊
生产力和生产关系	生產力和生產關【係】
恶魔城月下夜想曲	【惡】魔城月下夜想【曲】
只要能和你在一起	【只】要能和你在一起
相关评论进入论坛	相關評論進入論【壇】
智者千虑必有一失	智者【千】慮必有一失
德意志联邦共和国	德意【志】聯邦共和國
公司的法定代表人	公司的法定代【表】人
费了九牛二虎之力	費【了】九牛二虎之力
生命中的最后一天	生命中的最【後】一天
医院信息管理系统	醫院信息管理【係】統
直到现在我才明白	直到現在我【才】明白
中国网络游戏产业	中國網絡【遊】戲產業
职业能力倾向测验	職業能力傾【向】測驗
国家税务总局发布	國家稅務總局【發】【佈】
钢铁产业发展政策	鋼鐵產業【發】展政策
香港特别行政区第	香港特【別】行政區第
互联网络发展状况	互聯網絡【發】展狀況
那我就不知道了啊	那我就不知道【了】啊
不知道发生了什么	不知道【發】生【了】什麼
为了自己喜欢的人	爲【了】自己喜歡的人
自己动手丰衣足食	自己動手【豐】衣足食
卫生部新闻发言人	衛生部新聞【發】言人
封闭式基金折价率	封閉式基金【折】價率
冬季到台北来看雨	【冬】季到【臺】北來看雨
麻雀虽小五脏俱全	麻雀雖小五【髒】俱全
爱一个人并不一定	愛一個人【並】不一定
汽车产业发展政策	汽車產業【發】展政策
吐鲁番的葡萄熟了	吐魯番的葡萄熟【了】
温州职业技术学院	溫州職業技【術】學院
我学会了很多东西	我學會【了】很多東西
不知道怎么回事啊	不知道怎麼【回】事啊
律师事务所合伙人	律師事務所合【夥】人
已经有了另一个人	已經有【了】另一個人
一切都是过眼云烟	一切都是過眼【雲】【煙】
一夫当关万夫莫开	一夫【當】關【萬】夫莫開
南京大屠杀幸存者	南京大屠殺【幸】存者
为什么不说心里话	爲什麼不說心【里】話
有福同享有难同当	有福【同】享有難【同】【當】
从此一发不可收拾	從此一【發】不可收拾
达到历史最高水平	達到【歷】史最高水平
只见树木不见森林	【只】見樹木不見森林
我是一棵秋天的树	我是一棵【秋】天的樹
大力发展资本市场	大力【發】展資本市場
根据世界卫生组织	根【據】世界衛生組織
直到现在我才发现	直到現在我【才】【發】現
型高致病性禽流感	型高【致】病性禽流感
好久没有看见你了	好久沒有看見你【了】
新闻出版总署副署	新聞【出】版總署副署
进出口商品检验局	進【出】口商品檢驗局
日前接受记者采访	日前接受記者【採】訪
不知道怎么去面对	不知道怎麼去【面】對
根据中国人民银行	根【據】中國人民銀行
如有雷同纯属巧合	如有雷【同】純屬巧合
复方氨酚烷胺胶囊	【復】方氨酚烷胺膠囊
青出于蓝而胜于蓝	青【出】於藍而勝於藍
系统配置实用程序	【係】統配置實用程序
世界的和平与发展	世界的和平與【發】展
千里之堤溃于蚁穴	【千】【里】之堤潰於蟻穴
你现在在干什么啊	你現在在【幹】什麼啊
台湾民主自治同盟	【臺】灣民主自治【同】盟
新闻出版总署署长	新聞【出】版總署署長
万万没有想到的是	【萬】【萬】沒有想到的是
在全国范围内展开	在全國【範】圍內展開
我不是告诉你了吗	我不是告訴你【了】嗎
阜新蒙古族自治县	阜新【蒙】古族自治縣
前事不忘后事之师	前事不忘【後】事之師
北京师范大学教授	北京師【範】大學教授
一个国家两种制度	一個國家兩【種】【制】度
我以为你不理我了	我以爲你不理我【了】
引无数英雄竞折腰	引無數英雄競【折】腰
中国历史上第一个	中國【歷】史上第一個
只可意会不可言传	【只】可意會不可言傳
如果有一天我死了	如果有一天我死【了】
外交部发言人孔泉	外交部【發】言人孔泉
比上不足比下有余	比上不足比下有【餘】
万事俱备只欠东风	【萬】事俱備【只】欠東風
国务院总理朱镕基	國務院總理【朱】鎔基
国家发改委能源局	國家【發】改委能源局
上有天堂下有苏杭	上有天堂下有【蘇】杭
为了自己所爱的人	爲【了】自己所愛的人
不知道该怎么办了	不知道該怎麼辦【了】
才下眉头却上心头	【才】下眉頭卻上心頭
生产力与生产关系	生產力與生產關【係】
究竟是怎么一回事	究竟是怎麼一【回】事
一点机会都没有了	一點機會都沒有【了】
老骥伏枥志在千里	老驥伏櫪【志】在【千】【里】
最高人民法院核准	最高人民法院核【準】
螳螂捕蝉黄雀在后	螳螂捕蟬黃雀在【後】
奠定了扎实的基础	奠定【了】【扎】實的基礎
参拜靖国神社问题	【參】拜靖國神社問題
美国国务院发言人	美國國務院【發】言人
狗嘴里吐不出象牙	狗嘴【里】吐不【出】象牙
出席了新闻发布会	【出】席【了】新聞【發】【佈】會
一个愿打一个愿挨	一個願打一個願【挨】
攻无不克战无不胜	攻無不【克】戰無不勝
欲加之罪何患无辞	【欲】加之罪何患無辭
捡了芝麻丢了西瓜	撿【了】芝麻丟【了】西瓜
锲而不舍金石可镂	鍥而不【舍】金石可鏤
种瓜得瓜种豆得豆	【種】瓜得瓜【種】豆得豆
教育部新闻发言人	教育部新聞【發】言人
召开了新闻发布会	召開【了】新聞【發】【佈】會
停止参拜靖国神社	停止【參】拜靖國神社
提高单位面积产量	提高單位【面】積產量
莫等闲白了少年头	莫等閑白【了】少年頭
奥林匹克森林公园	奧林匹【克】森林公園
新闻发布会在北京	新聞【發】【佈】會在北京
中国人民银行宣布	中國人民銀行宣【佈】
直到今天我才发现	直到今天我【才】【發】現
北京国际马拉松赛	北京國際馬拉【鬆】賽
木垒哈萨克自治县	木壘哈薩【克】自治縣
不知道怎么办才好	不知道怎麼辦【才】好
主教练里杰卡尔德	主教練【里】【傑】卡爾德
明枪易躲暗箭难防	明槍易躲【暗】箭難防
昨天接受记者采访	昨天接受記者【採】訪
成事不足败事有余	成事不足敗事有【餘】
王婆卖瓜自卖自夸	王婆賣瓜自賣自【誇】
现场总线控制系统	現場總線控【制】【係】統
马斯特里赫特条约	馬斯特【里】赫特條約
前不着村后不着店	前不著村【後】不著店
建筑抗震设计规范	建【築】抗震設計規【範】
公安局新闻发言人	公安局新聞【發】言人
最熟悉的陌生人了	最熟悉的陌生人【了】
胡锦涛总书记的重	【胡】錦濤總書記的重
据外交部网站消息	【據】外交部網站消息
基本输入输出系统	基本輸入輸【出】【係】統
只知其一不知其二	【只】知其一不知其二
甲状腺机能亢进症	甲狀腺機能亢進【症】
王侯将相宁有种乎	王侯將相寧有【種】乎
患有先天性心脏病	患有先天性心【髒】病
中国国民党副主席	中國國民【黨】副主席
北京师范大学金融	北京師【範】大學金融
一日不见如隔三秋	一日不見如隔三【秋】
关系的进一步发展	關【係】的進一步【發】展
旁观者清当局者迷	旁觀者清【當】局者迷
北京日报报业集团	北京日報報業集【團】
梅里斯达斡尔族区	梅【里】斯達斡爾族區
美国通用会计准则	美國通用會計【準】則
造血干细胞捐献者	造血【幹】細胞捐獻者
河南蒙古族自治县	河南【蒙】古族自治縣
可移植的操作系统	可移植的操作【係】統
特雷西麦克格雷迪	特雷西麥【克】格雷迪
就可以单向收费了	就可以單【向】收費【了】
发展友好合作关系	【發】展友好合作關【係】
千里之堤毁于蚁穴	【千】【里】之堤毀於蟻穴
半路杀出个程咬金	半路殺【出】個程咬金
昨日接受记者采访	昨日接受記者【採】訪
不怕一万就怕万一	不怕一【萬】就怕【萬】一
病态窦房结综合征	病態竇房結綜合【徵】
在巴西里约热内卢	在巴西【里】約熱內盧
大难不死必有后福	大難不死必有【後】福
张家川回族自治县	張家川【回】族自治縣
签订股权分置改革	【籖】訂股權分置改革
箭在弦上不得不发	箭在弦上不得不【發】
跑了和尚跑不了庙	跑【了】和尚跑不【了】廟
燕雀安知鸿鹄之志	燕雀安知鴻鵠之【志】
斯德哥尔摩综合症	斯德哥爾摩綜合【症】
哥伦布发现新大陆	哥倫【佈】【發】現新大陸
首相参拜靖国神社	首相【參】拜靖國神社
出其不意攻其不备	【出】其不意攻其不備
老王卖瓜自卖自夸	老王賣瓜自賣自【誇】
春生夏长秋收冬藏	春生夏長【秋】收【冬】藏
一言既出驷马难追	一言既【出】駟馬難追
早知今日何必当初	早知今日何必【當】初
农村发展研究中心	農村【發】展研究中心
科研项目奥林匹克	科研項目奧林匹【克】
动脉硬化性心脏病	動脈硬化性心【髒】病
商品住宅空置面积	商品住宅空置【面】積
这是一种什么样的	這是一【種】什麼樣的
新闻出版总署音像	新聞【出】版總署音像
佛罗里达州肯尼迪	佛羅【里】達州肯尼迪
自力更生丰衣足食	自力更生【豐】衣足食
你快回来你快回来	你快【回】來你快【回】來
伊朗外交部发言人	伊朗外交部【發】言人
股指期货即将推出	股指期貨即將推【出】
兼听则明偏信则暗	兼聽則明偏信則【暗】
亚麻色头发的少女	亞麻色頭【發】的少女
那你现在在哪里啊	那你現在在哪【里】啊
大门不出二门不迈	大門不【出】二門不邁
国际复兴开发银行	國際【復】興開【發】銀行
真人面前不说假话	真人【面】前不說假話
养兵千日用兵一时	養兵【千】日用兵一時
费尽九牛二虎之力	費【盡】九牛二虎之力
中国民族网络游戏	中國民族網絡【遊】戲
暗暗啊啊啊啊啊啊	【暗】【暗】啊啊啊啊啊啊
你现在在干什么呀	你現在在【幹】什麼呀
注射用头孢哌酮钠	【注】射用頭孢哌酮鈉
只是一个时间问题	【只】是一個時間問題
圣皮埃尔和密克隆	聖皮埃爾和密【克】隆
左氧氟沙星注射液	左氧氟沙星【注】射液
弱水三千只取一瓢	弱水三【千】【只】取一瓢
前人栽树后人乘凉	前人栽樹【後】人乘涼
开放的数据库连接	開放的數【據】庫連接
美军士兵在伊拉克	美軍士兵在伊拉【克】
苦海无边回头是岸	苦海無邊【回】頭是岸
可是你一定要幸福	可是你一定要【幸】福
面向对象编程语言	【面】【向】對象編程語言
爱上一个人只需要	愛上一個人【只】需要
纳斯达克股票市场	納斯達【克】股票市場
可编程逻辑控制器	可編程邏輯控【制】器
那你什么时候回去	那你什麼時候【回】去
发生特大瓦斯爆炸	【發】生特大瓦斯爆炸
士别三日刮目相看	士【別】三日【刮】目相看
第一次见面的时候	第一次見【面】的時候
在短短的几年之内	在短短的【幾】年之內
欲加之罪何患无词	【欲】加之罪何患無詞
十九岁的最后一天	十九歲的最【後】一天
你是干什么工作的	你是【幹】什麼工作的
在主席台就座的有	在主席【臺】就座的有
战无不胜攻无不克	戰無不勝攻無不【克】
国防部长伊万诺夫	國防部長伊【萬】諾夫
你什么时候回来呀	你什麼時候【回】來呀
日出而作日入而息	日【出】而作日入而息
系统资源管理程序	【係】統資源管理程序
我们什么时候才能	我們什麼時候【才】能
继续参拜靖国神社	繼續【參】拜靖國神社
不知道说什么才好	不知道說什麼【才】好
千军易得一将难求	【千】軍易得一將難求
奥妮克希亚的头颅	奧妮【克】希亞的頭顱
注射用头孢曲松钠	【注】射用頭孢【曲】【鬆】鈉
毫无准备的情况下	毫無【準】備的情況下
再次参拜靖国神社	再次【參】拜靖國神社
希尔斯布莱德丘陵	希爾斯【佈】萊德丘陵
应当立案而不立案	應【當】立案而不立案
频道更多精彩内容	頻道更多精【彩】內容
注射用头孢噻肟钠	【注】射用頭孢噻肟鈉
那我就不打扰你了	那我就不打擾你【了】
不知什么时候才能	不知什麼時候【才】能
差之毫厘失之千里	差之毫釐失之【千】【里】
要到什么时候才能	要到什麼時候【才】能
你什么时候回去的	你什麼時候【回】去的
复方氨基酸注射液	【復】方氨基酸【注】射液
我的地盘我说了算	我的地盤我說【了】算
游泳运动管理中心	【遊】泳運動管理中心
党十一届三中全会	【黨】十一屆三中全會
行业协会游戏软件	行業協會【遊】戲軟件
社会发展十年规划	社會【發】展十年規【劃】
四体不勤五谷不分	四體不勤五【谷】不分
技术经济研究中心	技【術】經濟研究中心
什么时候才能真正	什麼時候【才】能真正
这就是你的不对了	這就是你的不對【了】
百足之虫死而不僵	百足之蟲死而不【僵】
青菜萝卜各有所爱	青菜蘿【卜】各有所愛
参议院军事委员会	【參】議院軍事委員會
六方会谈共同声明	六方會談共【同】聲明
别拿版主不当干部	【別】拿版主不【當】【幹】部
二号人物扎瓦赫里	二號人物【扎】瓦赫【里】
不管以后发生什么	不管以【後】【發】生什麼
西安人民广播电台	西安人民廣播電【臺】
爱我别走如果你说	愛我【別】走如果你說
仇人相见分外眼红	【仇】人相見分外眼紅
送君千里终须一别	送君【千】【里】終【須】一【別】
蜂王浆冻干粉含片	蜂王漿凍【幹】粉含片
肃北蒙古族自治县	肅北【蒙】古族自治縣
一叶落而知天下秋	一葉落而知天下【秋】
什么也没有发生过	什麼也沒有【發】生過
外交部新闻发言人	外交部新聞【發】言人
不怕一万只怕万一	不怕一【萬】【只】怕【萬】一
兼听则明偏听则暗	兼聽則明偏聽則【暗】
两虎相斗必有一伤	兩虎相【鬭】必有一傷
葡萄糖酸钙注射液	葡萄糖酸鈣【注】射液
攻其一点不及其余	攻其一點不及其【餘】
在一定历史条件下	在一定【歷】史條件下
差之毫厘谬以千里	差之毫釐謬以【千】【里】
可编程只读存储器	可編程【只】讀存儲器
甲状腺机能减退症	甲狀腺機能減退【症】
丝毫都没有注意到	絲毫都沒有【注】意到
兄弟同心其力断金	兄弟【同】心其力斷金
风机盘管空调系统	風機盤管空調【係】統
注射用氨苄西林钠	【注】射用氨苄西林鈉
珠江经济广播电台	珠江經濟廣播電【臺】
什么时候才能找到	什麼時候【才】能找到
一切都是命中注定	一切都是命中【注】定
有难同当有福同享	有難【同】【當】有福【同】享
老总已经呆在那里	老總已經呆在那【里】
复杂指令集计算机	【復】雜指令集計算機
最后一次为你难过	最【後】一次爲你難過
武装力量总参谋长	武裝力量總【參】謀長
明尼苏达森林狼队	明尼【蘇】達森林狼隊
不当家不知柴米贵	不【當】家不知柴米貴
你什么时候回来的	你什麼時候【回】來的
愚者千虑必有一得	愚者【千】慮必有一得
逻辑链路控制协议	邏輯【鏈】路控【制】協議
拳不离手曲不离口	拳不離手【曲】不離口
黄钟毁弃瓦釜雷鸣	黃【鍾】毀棄瓦釜雷鳴
失之毫厘差之千里	失之毫釐差之【千】【里】
肠出血性大肠杆菌	腸【出】血性大腸桿菌
你的爸爸会得绝症	你的爸爸會得絕【症】
当断不断反受其乱	【當】斷不斷反受其亂
人中吕布马中赤兔	人中呂【佈】馬中赤兔
靡不有初鲜克有终	靡不有初鮮【克】有終
同声相应同气相求	【同】聲相應【同】氣相求
茕茕孑立形影相吊	煢煢孑立形影相【吊】
什么时候才能结束	什麼時候【才】能結束
尽信书则不如无书	【盡】信書則不如無書
中枢神经系统障碍	中樞神經【係】統障礙
活要见人死要见尸	活要見人死要見【屍】
失之毫厘谬以千里	失之毫釐謬以【千】【里】
律师执业行为规范	律師執業行爲規【範】
啊啊啊啊啊啊暗暗	啊啊啊啊啊啊【暗】【暗】
明修栈道暗度陈仓	明修棧道【暗】度陳倉
西班牙皇家马德里	西班牙皇家馬德【里】
早日康复早日康复	早日康【復】早日康【復】
既有今日何必当初	既有今日何必【當】初
不知道为什么心里	不知道爲什麼心【里】
周期非特异性药物	【周】期非特異性【藥】物
王子犯法与民同罪	王子犯法與民【同】罪
这份感情难分难舍	這份感情難分難【舍】
在房间里走来走去	在房間【里】走來走去
直到今天我才知道	直到今天我【才】知道
比赛中的精彩瞬间	比賽中的精【彩】瞬間
有一分热发一分光	有一分熱【發】一分光
媒体访问控制协议	媒體訪問控【制】協議
里姆斯基柯萨科夫	【里】姆斯基柯薩科夫
小儿化痰止咳冲剂	小兒化痰止咳【衝】劑
提出股权分置改革	提【出】股權分置改革
二人同心其利断金	二人【同】心其利斷金
安徽省教育出版社	安徽省教育【出】版社
采取不正当的手段	【採】取不正【當】的手段
什么时候才能回来	什麼時候【才】能【回】來
皇家马德里俱乐部	皇家馬德【里】俱樂部
芬克的熔岩挖掘器	芬【克】的熔【巖】挖掘器
通常不是同一个人	通常不是【同】一個人
白刀子进红刀子出	白刀子進紅刀子【出】
从善如登从恶如崩	從善如登從【惡】如崩
里姆斯基科萨科夫	【里】姆斯基科薩科夫
只用了十分钟不到	【只】用【了】十分【鍾】不到
只此一家别无分店	【只】此一家【別】無分店
即插即用操作系统	即插即用操作【係】統
下笔千言离题万里	下筆【千】言離題【萬】【里】
小儿速效感冒冲剂	小兒速效感冒【衝】劑
大星术师索兰莉安	大星【術】師索蘭莉安
我一个人迎面而来	我一個人迎【面】而來
丑媳妇总得见公婆	【醜】媳婦總得見公婆
最近不知道怎么了	最近不知道怎麼【了】
仇人见面分外眼红	【仇】人見【面】分外眼紅
点击更多精彩内容	點擊更多精【彩】內容
证券期货监管系统	證券期貨監管【係】統
椭圆曲线密码体制	橢圓【曲】線密碼體【制】
在某一天回到从前	在某一天【回】到從前
肺泡表面活性物质	肺泡【表】【面】活性物質
春夏秋冬有多少人	春夏【秋】【冬】有多少人
法国国家交响乐团	法國國家交響樂【團】
出其不意攻其无备	【出】其不意攻其無備
病从口入祸从口出	病從口入禍從口【出】
好话说尽坏事做绝	好話說【盡】壞事做絕
坚持参拜靖国神社	堅持【參】拜靖國神社
硫酸软骨素注射液	硫酸軟骨素【注】射液
可编程控制计算机	可編程控【制】計算機
树高千丈叶落归根	樹高【千】丈葉落歸根
不知道该怎么表达	不知道該怎麼【表】達
综合决策支持系统	綜合決策支持【係】統
西游记之仙履奇缘	西【遊】記之仙履奇緣
差以毫厘谬以千里	差以毫釐謬以【千】【里】
当面是人背后是鬼	【當】【面】是人背【後】是鬼
进思尽忠退思补过	進思【盡】忠退思補過
